AAAAAGTATTTTTCTACAA -> AAAAGTATTTTTCTACAAT
AAAAATAAGACTACGGCGC -> AAAATAAGACTACGGCGCT
AAAACGGCACCTCATGTCG -> AAACGGCACCTCATGTCGC
AAAAGTATTTTTCTACAAT -> AAAGTATTTTTCTACAATA
AAAATAAGACTACGGCGCT -> AAATAAGACTACGGCGCTA
AAAATCCAAAAATAAGACT -> AAATCCAAAAATAAGACTA
AAACACTCCATATGCCAGC -> AACACTCCATATGCCAGCC
AAACCAGGGGTGTAATGCC -> AACCAGGGGTGTAATGCCC
AAACCGATCTGTATCGTTG -> AACCGATCTGTATCGTTGG
AAACGCTGGTAGGTGGCCT -> AACGCTGGTAGGTGGCCTT
AAACGGCACCTCATGTCGC -> AACGGCACCTCATGTCGCA
AAACGGTTGACTTCGCAAA -> AACGGTTGACTTCGCAAAG
AAACTCCCTATATAAGGAG -> AACTCCCTATATAAGGAGG
AAAGAAACGGTTGACTTCG -> AAGAAACGGTTGACTTCGC
AAAGACCATTTACTTGCCT -> AAGACCATTTACTTGCCTA
AAAGAGTGCAACCGGGTCC -> AAGAGTGCAACCGGGTCCA
AAAGATTTTCCGGTGATAT -> AAGATTTTCCGGTGATATA
AAAGCTCGCCGAGTCCGAT -> AAGCTCGCCGAGTCCGATC
AAAGGACTCAGACATGCAC -> AAGGACTCAGACATGCACC
AAAGGATCAACGTCTGGAT -> AAGGATCAACGTCTGGATT
AAAGGATCTCAGCTGAATA -> AAGGATCTCAGCTGAATAT
AAAGTATTTTTCTACAATA -> AAGTATTTTTCTACAATAA
AAAGTTTTTTGCTCCTCGG -> AAGTTTTTTGCTCCTCGGC
AAATAAGACTACGGCGCTA -> AATAAGACTACGGCGCTAA
AAATCCAAAAATAAGACTA -> AATCCAAAAATAAGACTAC
AAATTGGGTCGATGACAAT -> AATTGGGTCGATGACAATA
AACAATCACTAGGTTTGCC -> ACAATCACTAGGTTTGCCG
AACACTCCATATGCCAGCC -> ACACTCCATATGCCAGCCT
AACAGCGGCGTTAAACCGA -> ACAGCGGCGTTAAACCGAT
AACAGCTAACAATCACTAG -> ACAGCTAACAATCACTAGG
AACAGGGAGACCTAGAATT -> ACAGGGAGACCTAGAATTT
AACATAACGTACGGATCTC -> ACATAACGTACGGATCTCA
AACATATATGTGTTCAAAG -> ACATATATGTGTTCAAAGT
AACCACAGATTTTTTTGTA -> ACCACAGATTTTTTTGTAA
AACCAGGGGTGTAATGCCC -> ACCAGGGGTGTAATGCCCA
AACCCTCGTTTACGTAGGC -> ACCCTCGTTTACGTAGGCT
AACCCTGGAATTCTTTCGT -> ACCCTGGAATTCTTTCGTT
AACCGATCTGTATCGTTGG -> ACCGATCTGTATCGTTGGT
AACCGGGTCCAGGAAGTAA -> ACCGGGTCCAGGAAGTAAG
AACCGGTCTGCCCACATAA -> ACCGGTCTGCCCACATAAA
AACGCAGTGCATTTAGGTA -> ACGCAGTGCATTTAGGTAG
AACGCATAACAGGGAGACC -> ACGCATAACAGGGAGACCT
AACGCTGGTAGGTGGCCTT -> ACGCTGGTAGGTGGCCTTC
AACGGCACCTCATGTCGCA -> ACGGCACCTCATGTCGCAG
AACGGTACTGCGATTTACA -> ACGGTACTGCGATTTACAC
AACGGTTGACTTCGCAAAG -> ACGGTTGACTTCGCAAAGA
AACGTACGGATCTCATGGA -> ACGTACGGATCTCATGGAT
AACGTCTGGATTGAGCGGT -> ACGTCTGGATTGAGCGGTA
AACGTGTATCTCGATCCGC -> ACGTGTATCTCGATCCGCG
AACGTTTTAAGGACTCGTC -> ACGTTTTAAGGACTCGTCT
AACTACTTCTGTTCGCGAA -> ACTACTTCTGTTCGCGAAG
AACTCAGGTAACGCAGTGC -> ACTCAGGTAACGCAGTGCA
AACTCATTCCCGGGCTTGT -> ACTCATTCCCGGGCTTGTT
AACTCCCTATATAAGGAGG -> ACTCCCTATATAAGGAGGG
AACTGATAAGCCGCCAGCG -> ACTGATAAGCCGCCAGCGA
AACTGCTTTACTGTTCGAT -> ACTGCTTTACTGTTCGATA
AACTTAAGAAATAGAACCT -> ACTTAAGAAATAGAACCTT
AACTTCGTCGTAACGTTTT -> ACTTCGTCGTAACGTTTTA
AACTTGCATAGCTGTTGAG -> ACTTGCATAGCTGTTGAGA
AAGAAACGGTTGACTTCGC -> AGAAACGGTTGACTTCGCA
AAGACCATCGAAGTGTCGA -> AGACCATCGAAGTGTCGAT
AAGACCATTTACTTGCCTA -> AGACCATTTACTTGCCTAC
AAGACTACGGCGCTAATCA -> AGACTACGGCGCTAATCAT
AAGAGGGGGTTGCCCACTT -> AGAGGGGGTTGCCCACTTG
AAGAGTGATCTCACAATTT -> AGAGTGATCTCACAATTTA
AAGAGTGCAACCGGGTCCA -> AGAGTGCAACCGGGTCCAG
AAGATGAACCACAGATTTT -> AGATGAACCACAGATTTTT
AAGATTTTCCGGTGATATA -> AGATTTTCCGGTGATATAC
AAGCACGGACGCGTAATAA -> AGCACGGACGCGTAATAAG
AAGCCCTGGGAAGATGAAC -> AGCCCTGGGAAGATGAACC
AAGCCGCCAGCGAGCTATG -> AGCCGCCAGCGAGCTATGG
AAGCCGGCCAGTTTAATCA -> AGCCGGCCAGTTTAATCAC
AAGCGAATTCCTTTATCTA -> AGCGAATTCCTTTATCTAA
AAGCGTCTATCCAACAGCG -> AGCGTCTATCCAACAGCGG
AAGCTCGCCGAGTCCGATC -> AGCTCGCCGAGTCCGATCG
AAGCTCTAAAGGATCAACG -> AGCTCTAAAGGATCAACGT
AAGGACAAAACGGCACCTC -> AGGACAAAACGGCACCTCA
AAGGACCATCTTCGATTGA -> AGGACCATCTTCGATTGAT
AAGGACTCAGACATGCACC -> AGGACTCAGACATGCACCA
AAGGACTCGTCTTACGATG -> AGGACTCGTCTTACGATGG
AAGGAGGGGGGTCCTCTTT -> AGGAGGGGGGTCCTCTTTG
AAGGATCAACGTCTGGATT -> AGGATCAACGTCTGGATTG
AAGGATCTCAGCTGAATAT -> AGGATCTCAGCTGAATATA
AAGGGCGAATAGTCGTCGG -> AGGGCGAATAGTCGTCGGA
AAGGGTCCAAGCACGGACG -> AGGGTCCAAGCACGGACGC
AAGTAAGAGGGGGTTGCCC -> AGTAAGAGGGGGTTGCCCA
AAGTATTTTTCTACAATAA -> AGTATTTTTCTACAATAAT
AAGTGTCGATTTCCTTGCT -> AGTGTCGATTTCCTTGCTC
AAGTGTCGCCGGGGTTTTG -> AGTGTCGCCGGGGTTTTGT
AAGTTAATTCGCCTCCGCC -> AGTTAATTCGCCTCCGCCT
AAGTTTTTTGCTCCTCGGC -> AGTTTTTTGCTCCTCGGCC
AATAAGACTACGGCGCTAA -> ATAAGACTACGGCGCTAAT
AATAAGGACCATCTTCGAT -> ATAAGGACCATCTTCGATT
AATAATATGAGGCACAAGC -> ATAATATGAGGCACAAGCT
AATAATATGAGGCACTAAC -> ATAATATGAGGCACTAACG
AATAATATGAGGCACTGTC -> ATAATATGAGGCACTGTCA
AATAATATGAGGCAGCTGA -> ATAATATGAGGCAGCTGAA
AATACAAGTGTCGCCGGGG -> ATACAAGTGTCGCCGGGGT
AATACAGAAGCCCTGGGAA -> ATACAGAAGCCCTGGGAAG
AATACTCAGCCCAAAGGAT -> ATACTCAGCCCAAAGGATC
AATAGTCGTCGGAGGTGCG -> ATAGTCGTCGGAGGTGCGT
AATAGTTTAGTAGGTCTTC -> ATAGTTTAGTAGGTCTTCT
AATATAAAAAGTATTTTTC -> ATATAAAAAGTATTTTTCT
AATATACTCCACAGAGGTC -> ATATACTCCACAGAGGTCT
AATATAGCTAGTGAGACTC -> ATATAGCTAGTGAGACTCT
AATATATAGTCCATAGATC -> ATATATAGTCCATAGATCT
AATATGAGGCACAAGCTCT -> ATATGAGGCACAAGCTCTA
AATATGAGGCACTAACGCA -> ATATGAGGCACTAACGCAT
AATATGAGGCACTGTCATT -> ATATGAGGCACTGTCATTC
AATATGAGGCAGCTGAATA -> ATATGAGGCAGCTGAATAT
AATATGTTATACGGATTCT -> ATATGTTATACGGATTCTC
AATCACAAAATCCAAAAAT -> ATCACAAAATCCAAAAATA
AATCACTAGGTTTGCCGGA -> ATCACTAGGTTTGCCGGAG
AATCATAACTCAGGTAACG -> ATCATAACTCAGGTAACGC
AATCATTAGAACTTGCATA -> ATCATTAGAACTTGCATAG
AATCCAAAAATAAGACTAC -> ATCCAAAAATAAGACTACG
AATCTACAGAATTGACTTG -> ATCTACAGAATTGACTTGC
AATGCCCATTAAACGCTGG -> ATGCCCATTAAACGCTGGT
AATGCCGACCTAGCTGAAC -> ATGCCGACCTAGCTGAACA
AATGCTAAAGACCATTTAC -> ATGCTAAAGACCATTTACT
AATGTACCTACGTCATACT -> ATGTACCTACGTCATACTC
AATTCCACTTAAGGGCGAA -> ATTCCACTTAAGGGCGAAT
AATTCCTTTATCTAAACAC -> ATTCCTTTATCTAAACACT
AATTCGCCTCCGCCTTTCG -> ATTCGCCTCCGCCTTTCGA
AATTCTTTCGTTGTTGAGA -> ATTCTTTCGTTGTTGAGAA
AATTGACTTGCATGTTGCA -> ATTGACTTGCATGTTGCAT
AATTGGGTCGATGACAATA -> ATTGGGTCGATGACAATAT
AATTGTATCCCTCTGTGGC -> ATTGTATCCCTCTGTGGCA
AATTTAAAGAAACGGTTGA -> ATTTAAAGAAACGGTTGAC
AATTTGGGCGGACAGCGGC -> ATTTGGGCGGACAGCGGCC
ACAAAACGGCACCTCATGT -> CAAAACGGCACCTCATGTC
ACAAAATCCAAAAATAAGA -> CAAAATCCAAAAATAAGAC
ACAACATAACGTACGGATC -> CAACATAACGTACGGATCT
ACAACTACTTCTGTTCGCG -> CAACTACTTCTGTTCGCGA
ACAAGCTCTAAAGGATCAA -> CAAGCTCTAAAGGATCAAC
ACAAGTGTCGCCGGGGTTT -> CAAGTGTCGCCGGGGTTTT
ACAATAATATGAGGCACAA -> CAATAATATGAGGCACAAG
ACAATAATATGAGGCACTA -> CAATAATATGAGGCACTAA
ACAATAATATGAGGCACTG -> CAATAATATGAGGCACTGT
ACAATAATATGAGGCAGCT -> CAATAATATGAGGCAGCTG
ACAATATGTTATACGGATT -> CAATATGTTATACGGATTC
ACAATCACTAGGTTTGCCG -> CAATCACTAGGTTTGCCGG
ACAATCATAACTCAGGTAA -> CAATCATAACTCAGGTAAC
ACAATTTAAAGAAACGGTT -> CAATTTAAAGAAACGGTTG
ACACCCTATACAGGGATCT -> CACCCTATACAGGGATCTC
ACACGCTTTGGTTTCCGCG -> CACGCTTTGGTTTCCGCGG
ACACTCCATATGCCAGCCT -> CACTCCATATGCCAGCCTC
ACAGAAGCCCTGGGAAGAT -> CAGAAGCCCTGGGAAGATG
ACAGAATTGACTTGCATGT -> CAGAATTGACTTGCATGTT
ACAGAGGTCTACAATAATA -> CAGAGGTCTACAATAATAT
ACAGATTTTTTTGTAAGAG -> CAGATTTTTTTGTAAGAGT
ACAGCGGCCGTGATCTTTT -> CAGCGGCCGTGATCTTTTT
ACAGCGGCGTTAAACCGAT -> CAGCGGCGTTAAACCGATC
ACAGCTAACAATCACTAGG -> CAGCTAACAATCACTAGGT
ACAGGGAGACCTAGAATTT -> CAGGGAGACCTAGAATTTG
ACAGGGATCTCAGCTGAAT -> CAGGGATCTCAGCTGAATA
ACAGTGAACTTAAGAAATA -> CAGTGAACTTAAGAAATAG
ACAGTGGGAATGTACCTAC -> CAGTGGGAATGTACCTACG
ACAGTGTTACGACGCGACC -> CAGTGTTACGACGCGACCT
ACATAAATTGGGTCGATGA -> CATAAATTGGGTCGATGAC
ACATAACGTACGGATCTCA -> CATAACGTACGGATCTCAT
ACATAGAACATATATGTGT -> CATAGAACATATATGTGTT
ACATATATGTGTTCAAAGT -> CATATATGTGTTCAAAGTT
ACATGCACCAAGCGTCTAT -> CATGCACCAAGCGTCTATC
ACATGCAGCCTTACTGGAT -> CATGCAGCCTTACTGGATG
ACCAAGCGTCTATCCAACA -> CCAAGCGTCTATCCAACAG
ACCACAGATTTTTTTGTAA -> CCACAGATTTTTTTGTAAG
ACCACGAACTCATTCCCGG -> CCACGAACTCATTCCCGGG
ACCAGATAGACCACGAACT -> CCAGATAGACCACGAACTC
ACCAGGGGTGTAATGCCCA -> CCAGGGGTGTAATGCCCAT
ACCATCGAAGTGTCGATTT -> CCATCGAAGTGTCGATTTC
ACCATCTTCGATTGATGAG -> CCATCTTCGATTGATGAGC
ACCATTTACTTGCCTACAT -> CCATTTACTTGCCTACATA
ACCCATATTAGGGTGCTAA -> CCCATATTAGGGTGCTAAA
ACCCCCCTATAACCCTGGA -> CCCCCCTATAACCCTGGAA
ACCCGCTCGCTCCTGAACG -> CCCGCTCGCTCCTGAACGT
ACCCTATACAGGGATCTCA -> CCCTATACAGGGATCTCAG
ACCCTCGTTTACGTAGGCT -> CCCTCGTTTACGTAGGCTG
ACCCTGGAATTCTTTCGTT -> CCCTGGAATTCTTTCGTTG
ACCGATCTGTATCGTTGGT -> CCGATCTGTATCGTTGGTA
ACCGGGTCCAGGAAGTAAG -> CCGGGTCCAGGAAGTAAGA
ACCGGTCTGCCCACATAAA -> CCGGTCTGCCCACATAAAT
ACCTACGTCATACTCCAGA -> CCTACGTCATACTCCAGAT
ACCTAGAATTTGGGCGGAC -> CCTAGAATTTGGGCGGACA
ACCTAGCTGAACAGCTAAC -> CCTAGCTGAACAGCTAACA
ACCTCAACCGGTCTGCCCA -> CCTCAACCGGTCTGCCCAC
ACCTCATGTCGCAGGGGGG -> CCTCATGTCGCAGGGGGGT
ACCTTCTCCCCCTTGCCTC -> CCTTCTCCCCCTTGCCTCC
ACGAACTCATTCCCGGGCT -> CGAACTCATTCCCGGGCTT
ACGAAGCGAATTCCTTTAT -> CGAAGCGAATTCCTTTATC
ACGAATGCTAAAGACCATT -> CGAATGCTAAAGACCATTT
ACGACACCCTATACAGGGA -> CGACACCCTATACAGGGAT
ACGACGCGACCTTCTCCCC -> CGACGCGACCTTCTCCCCC
ACGACTGATATCAGATTGA -> CGACTGATATCAGATTGAG
ACGATGGAGTTCCTGTCCA -> CGATGGAGTTCCTGTCCAC
ACGATGTTCTGCCGACGCA -> CGATGTTCTGCCGACGCAT
ACGCAGTGCATTTAGGTAG -> CGCAGTGCATTTAGGTAGA
ACGCATAACAGGGAGACCT -> CGCATAACAGGGAGACCTA
ACGCATCCGCCTAGGTGTT -> CGCATCCGCCTAGGTGTTG
ACGCGACCTTCTCCCCCTT -> CGCGACCTTCTCCCCCTTG
ACGCGTAATAAGGACCATC -> CGCGTAATAAGGACCATCT
ACGCTGGTAGGTGGCCTTC -> CGCTGGTAGGTGGCCTTCT
ACGCTTTGGTTTCCGCGGA -> CGCTTTGGTTTCCGCGGAG
ACGGACGCGTAATAAGGAC -> CGGACGCGTAATAAGGACC
ACGGATCTCATGGATCTCA -> CGGATCTCATGGATCTCAG
ACGGATTCTCGAGGTAGTC -> CGGATTCTCGAGGTAGTCA
ACGGCACCTCATGTCGCAG -> CGGCACCTCATGTCGCAGG
ACGGCGCTAATCATTAGAA -> CGGCGCTAATCATTAGAAC
ACGGGCGGGACCCGCTCGC -> CGGGCGGGACCCGCTCGCT
ACGGTACTGCGATTTACAC -> CGGTACTGCGATTTACACG
ACGGTTGACTTCGCAAAGA -> CGGTTGACTTCGCAAAGAT
ACGTACGGATCTCATGGAT -> CGTACGGATCTCATGGATC
ACGTAGGCTGTCGCGACTA -> CGTAGGCTGTCGCGACTAG
ACGTCATACTCCAGATTAC -> CGTCATACTCCAGATTACG
ACGTCGATTGCGCGTCCAG -> CGTCGATTGCGCGTCCAGC
ACGTCGCTCAAGTTAATTC -> CGTCGCTCAAGTTAATTCG
ACGTCTGGATTGAGCGGTA -> CGTCTGGATTGAGCGGTAG
ACGTGTATCTCGATCCGCG -> CGTGTATCTCGATCCGCGT
ACGTTGTGGCACTGTTGCC -> CGTTGTGGCACTGTTGCCA
ACGTTTTAAGGACTCGTCT -> CGTTTTAAGGACTCGTCTT
ACTAACGCATAACAGGGAG -> CTAACGCATAACAGGGAGA
ACTACGGCGCTAATCATTA -> CTACGGCGCTAATCATTAG
ACTACTTCTGTTCGCGAAG -> CTACTTCTGTTCGCGAAGC
ACTAGGTTTGCCGGAGATC -> CTAGGTTTGCCGGAGATCT
ACTAGTGATTAGGTGTTTC -> CTAGTGATTAGGTGTTTCG
ACTCAGACATGCACCAAGC -> CTCAGACATGCACCAAGCG
ACTCAGCCCAAAGGATCTC -> CTCAGCCCAAAGGATCTCA
ACTCAGGTAACGCAGTGCA -> CTCAGGTAACGCAGTGCAT
ACTCATCGATTGCCGATAG -> CTCATCGATTGCCGATAGT
ACTCATTCCCGGGCTTGTT -> CTCATTCCCGGGCTTGTTC
ACTCCACAGAGGTCTACAA -> CTCCACAGAGGTCTACAAT
ACTCCAGATTACGTCGCTC -> CTCCAGATTACGTCGCTCA
ACTCCATATGCCAGCCTCG -> CTCCATATGCCAGCCTCGT
ACTCCCTATATAAGGAGGG -> CTCCCTATATAAGGAGGGG
ACTCGTCTTACGATGGAGT -> CTCGTCTTACGATGGAGTT
ACTCTACAATAATATGAGG -> CTCTACAATAATATGAGGC
ACTGATAAGCCGCCAGCGA -> CTGATAAGCCGCCAGCGAG
ACTGATATCAGATTGAGCA -> CTGATATCAGATTGAGCAG
ACTGCGATTTACACGCTTT -> CTGCGATTTACACGCTTTG
ACTGCTTTACTGTTCGATA -> CTGCTTTACTGTTCGATAC
ACTGGATGGGTAGGCCCGC -> CTGGATGGGTAGGCCCGCC
ACTGGGCGTCGGGGTTGCC -> CTGGGCGTCGGGGTTGCCG
ACTGTCATTCGAATACTCA -> CTGTCATTCGAATACTCAG
ACTGTTCGATACGAATGCT -> CTGTTCGATACGAATGCTA
ACTGTTGCCAATACAGAAG -> CTGTTGCCAATACAGAAGC
ACTTAAGAAATAGAACCTT -> CTTAAGAAATAGAACCTTG
ACTTAAGGGCGAATAGTCG -> CTTAAGGGCGAATAGTCGT
ACTTCCAGCCGTAGCTAAA -> CTTCCAGCCGTAGCTAAAG
ACTTCGCAAAGATTTTCCG -> CTTCGCAAAGATTTTCCGG
ACTTCGTCGTAACGTTTTA -> CTTCGTCGTAACGTTTTAA
ACTTCTGTTCGCGAAGCCG -> CTTCTGTTCGCGAAGCCGG
ACTTGAGATAACTGATAAG -> CTTGAGATAACTGATAAGC
ACTTGCATAGCTGTTGAGA -> CTTGCATAGCTGTTGAGAG
ACTTGCATGTTGCATGCCT -> CTTGCATGTTGCATGCCTC
ACTTGCCTACATAGAACAT -> CTTGCCTACATAGAACATA
ACTTGTTGCGCATTTAGAC -> CTTGTTGCGCATTTAGACG
ACTTTATTGCCCAGCCCAC -> CTTTATTGCCCAGCCCACT
AGAAACGGTTGACTTCGCA -> GAAACGGTTGACTTCGCAA
AGAACATATATGTGTTCAA -> GAACATATATGTGTTCAAA
AGAACTGCTTTACTGTTCG -> GAACTGCTTTACTGTTCGA
AGAACTTCGTCGTAACGTT -> GAACTTCGTCGTAACGTTT
AGAACTTGCATAGCTGTTG -> GAACTTGCATAGCTGTTGA
AGAAGCCCTGGGAAGATGA -> GAAGCCCTGGGAAGATGAA
AGAATAGTTTAGTAGGTCT -> GAATAGTTTAGTAGGTCTT
AGAATTGACTTGCATGTTG -> GAATTGACTTGCATGTTGC
AGAATTTGGGCGGACAGCG -> GAATTTGGGCGGACAGCGG
AGACATGCACCAAGCGTCT -> GACATGCACCAAGCGTCTA
AGACCACGAACTCATTCCC -> GACCACGAACTCATTCCCG
AGACCATCGAAGTGTCGAT -> GACCATCGAAGTGTCGATT
AGACCATTTACTTGCCTAC -> GACCATTTACTTGCCTACA
AGACCTAGAATTTGGGCGG -> GACCTAGAATTTGGGCGGA
AGACGACACCCTATACAGG -> GACGACACCCTATACAGGG
AGACTACGGCGCTAATCAT -> GACTACGGCGCTAATCATT
AGACTCTACAATAATATGA -> GACTCTACAATAATATGAG
AGAGATAGTGGTCATTTGT -> GAGATAGTGGTCATTTGTC
AGAGGAGTGTTCGAGTTGA -> GAGGAGTGTTCGAGTTGAC
AGAGGGGGTTGCCCACTTG -> GAGGGGGTTGCCCACTTGA
AGAGGTCATGTGGTCCGTG -> GAGGTCATGTGGTCCGTGT
AGAGGTCTACAATAATATG -> GAGGTCTACAATAATATGA
AGAGTGACAGTGAACTTAA -> GAGTGACAGTGAACTTAAG
AGAGTGATCTCACAATTTA -> GAGTGATCTCACAATTTAA
AGAGTGCAACCGGGTCCAG -> GAGTGCAACCGGGTCCAGG
AGATAACTGATAAGCCGCC -> GATAACTGATAAGCCGCCA
AGATAGACCACGAACTCAT -> GATAGACCACGAACTCATT
AGATAGTGGTCATTTGTCA -> GATAGTGGTCATTTGTCAC
AGATATAATGCCGACCTAG -> GATATAATGCCGACCTAGC
AGATCTACAATAATATGAG -> GATCTACAATAATATGAGG
AGATCTTCGCTACGATGTT -> GATCTTCGCTACGATGTTC
AGATGAACCACAGATTTTT -> GATGAACCACAGATTTTTT
AGATTACGTCGCTCAAGTT -> GATTACGTCGCTCAAGTTA
AGATTGAGCAGTCCACAAC -> GATTGAGCAGTCCACAACA
AGATTGCATTGTATTCATA -> GATTGCATTGTATTCATAC
AGATTTAGATTGCATTGTA -> GATTTAGATTGCATTGTAT
AGATTTTCCGGTGATATAC -> GATTTTCCGGTGATATACT
AGATTTTTTTGTAAGAGTG -> GATTTTTTTGTAAGAGTGA
AGCACGGACGCGTAATAAG -> GCACGGACGCGTAATAAGG
AGCAGTCCACAACATAACG -> GCAGTCCACAACATAACGT
AGCCATCTCTTGTAACCCT -> GCCATCTCTTGTAACCCTC
AGCCCAAAGGATCTCAGCT -> GCCCAAAGGATCTCAGCTG
AGCCCACTCATCGATTGCC -> GCCCACTCATCGATTGCCG
AGCCCAGTCTTAAACCAGG -> GCCCAGTCTTAAACCAGGG
AGCCCTGGGAAGATGAACC -> GCCCTGGGAAGATGAACCA
AGCCGCCAGCGAGCTATGG -> GCCGCCAGCGAGCTATGGG
AGCCGCGCCCACCCATATT -> GCCGCGCCCACCCATATTA
AGCCGGCCAGTTTAATCAC -> GCCGGCCAGTTTAATCACA
AGCCGTAGCTAAAGAGTGC -> GCCGTAGCTAAAGAGTGCA
AGCCTCGTAGGCCAGCTCT -> GCCTCGTAGGCCAGCTCTC
AGCCTTACTGGATGGGTAG -> GCCTTACTGGATGGGTAGG
AGCGAATTCCTTTATCTAA -> GCGAATTCCTTTATCTAAA
AGCGAGCTATGGGGAGAAC -> GCGAGCTATGGGGAGAACT
AGCGATGATTATCCAATTC -> GCGATGATTATCCAATTCC
AGCGGAAGGACAAAACGGC -> GCGGAAGGACAAAACGGCA
AGCGGCCGTGATCTTTTTG -> GCGGCCGTGATCTTTTTGC
AGCGGCGTTAAACCGATCT -> GCGGCGTTAAACCGATCTG
AGCGGTAGGAGCGGAAGGA -> GCGGTAGGAGCGGAAGGAC
AGCGTACGTCGATTGCGCG -> GCGTACGTCGATTGCGCGT
AGCGTCTATCCAACAGCGG -> GCGTCTATCCAACAGCGGC
AGCTAAAGAGTGCAACCGG -> GCTAAAGAGTGCAACCGGG
AGCTAACAATCACTAGGTT -> GCTAACAATCACTAGGTTT
AGCTAGATATAATGCCGAC -> GCTAGATATAATGCCGACC
AGCTAGTGAGACTCTACAA -> GCTAGTGAGACTCTACAAT
AGCTATGGGGAGAACTTCG -> GCTATGGGGAGAACTTCGT
AGCTCGCCGAGTCCGATCG -> GCTCGCCGAGTCCGATCGA
AGCTCTAAAGGATCAACGT -> GCTCTAAAGGATCAACGTC
AGCTCTCAAGACCATCGAA -> GCTCTCAAGACCATCGAAG
AGCTGAACAGCTAACAATC -> GCTGAACAGCTAACAATCA
AGCTGAATATAAAAAGTAT -> GCTGAATATAAAAAGTATT
AGCTGAATATACTCCACAG -> GCTGAATATACTCCACAGA
AGCTGAATATAGCTAGTGA -> GCTGAATATAGCTAGTGAG
AGCTGAATATATAGTCCAT -> GCTGAATATATAGTCCATA
AGCTGTTGAGAGATAGTGG -> GCTGTTGAGAGATAGTGGT
AGCTTGTGCGTACAATCAT -> GCTTGTGCGTACAATCATA
AGGAAGTAAGAGGGGGTTG -> GGAAGTAAGAGGGGGTTGC
AGGACAAAACGGCACCTCA -> GGACAAAACGGCACCTCAT
AGGACCATCTTCGATTGAT -> GGACCATCTTCGATTGATG
AGGACTCAGACATGCACCA -> GGACTCAGACATGCACCAA
AGGACTCGTCTTACGATGG -> GGACTCGTCTTACGATGGA
AGGAGCGGAAGGACAAAAC -> GGAGCGGAAGGACAAAACG
AGGAGGGGGGTCCTCTTTG -> GGAGGGGGGTCCTCTTTGT
AGGAGTGTTCGAGTTGACC -> GGAGTGTTCGAGTTGACCA
AGGATCAACGTCTGGATTG -> GGATCAACGTCTGGATTGA
AGGATCTCAGCTGAATATA -> GGATCTCAGCTGAATATAA
AGGCACAAGCTCTAAAGGA -> GGCACAAGCTCTAAAGGAT
AGGCACTAACGCATAACAG -> GGCACTAACGCATAACAGG
AGGCACTGTCATTCGAATA -> GGCACTGTCATTCGAATAC
AGGCAGCTGAATATACTCC -> GGCAGCTGAATATACTCCA
AGGCCAGCTCTCAAGACCA -> GGCCAGCTCTCAAGACCAT
AGGCCCGCCCCTCACCTCA -> GGCCCGCCCCTCACCTCAA
AGGCTGTCGCGACTAGTGA -> GGCTGTCGCGACTAGTGAT
AGGGAGACCTAGAATTTGG -> GGGAGACCTAGAATTTGGG
AGGGATCTCAGCTGAATAT -> GGGATCTCAGCTGAATATA
AGGGCGAATAGTCGTCGGA -> GGGCGAATAGTCGTCGGAG
AGGGGGGTACGTTGTGGCA -> GGGGGGTACGTTGTGGCAC
AGGGGGGTCCTCTTTGTGC -> GGGGGGTCCTCTTTGTGCC
AGGGGGTTGCCCACTTGAG -> GGGGGTTGCCCACTTGAGA
AGGGGTGTAATGCCCATTA -> GGGGTGTAATGCCCATTAA
AGGGTCCAAGCACGGACGC -> GGGTCCAAGCACGGACGCG
AGGGTGCTAAAGGACTCAG -> GGGTGCTAAAGGACTCAGA
AGGTAACGCAGTGCATTTA -> GGTAACGCAGTGCATTTAG
AGGTAGATTTAGATTGCAT -> GGTAGATTTAGATTGCATT
AGGTAGTCAATTGTATCCC -> GGTAGTCAATTGTATCCCT
AGGTCATGTGGTCCGTGTT -> GGTCATGTGGTCCGTGTTG
AGGTCTACAATAATATGAG -> GGTCTACAATAATATGAGG
AGGTCTTCTAATCTACAGA -> GGTCTTCTAATCTACAGAA
AGGTGCGTGTTTACGAAGC -> GGTGCGTGTTTACGAAGCG
AGGTGGCCTTCTATAGTTG -> GGTGGCCTTCTATAGTTGC
AGGTGTTGCCGACTGGGCG -> GGTGTTGCCGACTGGGCGT
AGGTGTTTCGTTTAAAGCT -> GGTGTTTCGTTTAAAGCTC
AGGTTTGCCGGAGATCTTC -> GGTTTGCCGGAGATCTTCG
AGTAAACTCCCTATATAAG -> GTAAACTCCCTATATAAGG
AGTAAGAGGGGGTTGCCCA -> GTAAGAGGGGGTTGCCCAC
AGTAGGTCTTCTAATCTAC -> GTAGGTCTTCTAATCTACA
AGTATTTTTCTACAATAAT -> GTATTTTTCTACAATAATA
AGTCAATTGTATCCCTCTG -> GTCAATTGTATCCCTCTGT
AGTCCACAACATAACGTAC -> GTCCACAACATAACGTACG
AGTCCATAGATCTACAATA -> GTCCATAGATCTACAATAA
AGTCCGATCGAAGGGTCCA -> GTCCGATCGAAGGGTCCAA
AGTCGTACAGTGTTACGAC -> GTCGTACAGTGTTACGACG
AGTCGTCGGAGGTGCGTGT -> GTCGTCGGAGGTGCGTGTT
AGTCTTAAACCAGGGGTGT -> GTCTTAAACCAGGGGTGTA
AGTGAACTTAAGAAATAGA -> GTGAACTTAAGAAATAGAA
AGTGACAGTGAACTTAAGA -> GTGACAGTGAACTTAAGAA
AGTGAGACTCTACAATAAT -> GTGAGACTCTACAATAATA
AGTGATCTCACAATTTAAA -> GTGATCTCACAATTTAAAG
AGTGATTAGGTGTTTCGTT -> GTGATTAGGTGTTTCGTTT
AGTGCAACCGGGTCCAGGA -> GTGCAACCGGGTCCAGGAA
AGTGCATTTAGGTAGATTT -> GTGCATTTAGGTAGATTTA
AGTGGGAATGTACCTACGT -> GTGGGAATGTACCTACGTC
AGTGGTCATTTGTCACTTC -> GTGGTCATTTGTCACTTCC
AGTGTCGATTTCCTTGCTC -> GTGTCGATTTCCTTGCTCT
AGTGTCGCCGGGGTTTTGT -> GTGTCGCCGGGGTTTTGTA
AGTGTTACGACGCGACCTT -> GTGTTACGACGCGACCTTC
AGTGTTCGAGTTGACCAGA -> GTGTTCGAGTTGACCAGAT
AGTTAATTCGCCTCCGCCT -> GTTAATTCGCCTCCGCCTT
AGTTACGACTGATATCAGA -> GTTACGACTGATATCAGAT
AGTTCCTGTCCACATGCAG -> GTTCCTGTCCACATGCAGC
AGTTGACCAGATAGACCAC -> GTTGACCAGATAGACCACG
AGTTGCTCTCTGGGCTCTG -> GTTGCTCTCTGGGCTCTGG
AGTTTAATCACAAAATCCA -> GTTTAATCACAAAATCCAA
AGTTTAGTAGGTCTTCTAA -> GTTTAGTAGGTCTTCTAAT
AGTTTTTTGCTCCTCGGCC -> GTTTTTTGCTCCTCGGCCA
ATAAAAAGTATTTTTCTAC -> TAAAAAGTATTTTTCTACA
ATAAATTGGGTCGATGACA -> TAAATTGGGTCGATGACAA
ATAACAGGGAGACCTAGAA -> TAACAGGGAGACCTAGAAT
ATAACCCTGGAATTCTTTC -> TAACCCTGGAATTCTTTCG
ATAACGTACGGATCTCATG -> TAACGTACGGATCTCATGG
ATAACTCAGGTAACGCAGT -> TAACTCAGGTAACGCAGTG
ATAACTGATAAGCCGCCAG -> TAACTGATAAGCCGCCAGC
ATAAGACTACGGCGCTAAT -> TAAGACTACGGCGCTAATC
ATAAGCCGCCAGCGAGCTA -> TAAGCCGCCAGCGAGCTAT
ATAAGGACCATCTTCGATT -> TAAGGACCATCTTCGATTG
ATAAGGAGGGGGGTCCTCT -> TAAGGAGGGGGGTCCTCTT
ATAATATGAGGCACAAGCT -> TAATATGAGGCACAAGCTC
ATAATATGAGGCACTAACG -> TAATATGAGGCACTAACGC
ATAATATGAGGCACTGTCA -> TAATATGAGGCACTGTCAT
ATAATATGAGGCAGCTGAA -> TAATATGAGGCAGCTGAAT
ATAATGCCGACCTAGCTGA -> TAATGCCGACCTAGCTGAA
ATACAAGTGTCGCCGGGGT -> TACAAGTGTCGCCGGGGTT
ATACAGAAGCCCTGGGAAG -> TACAGAAGCCCTGGGAAGA
ATACAGGGATCTCAGCTGA -> TACAGGGATCTCAGCTGAA
ATACGAATGCTAAAGACCA -> TACGAATGCTAAAGACCAT
ATACGGATTCTCGAGGTAG -> TACGGATTCTCGAGGTAGT
ATACGGGCGGGACCCGCTC -> TACGGGCGGGACCCGCTCG
ATACTCAGCCCAAAGGATC -> TACTCAGCCCAAAGGATCT
ATACTCCACAGAGGTCTAC -> TACTCCACAGAGGTCTACA
ATACTCCAGATTACGTCGC -> TACTCCAGATTACGTCGCT
ATACTTTATTGCCCAGCCC -> TACTTTATTGCCCAGCCCA
ATAGAACATATATGTGTTC -> TAGAACATATATGTGTTCA
ATAGACCACGAACTCATTC -> TAGACCACGAACTCATTCC
ATAGATCTACAATAATATG -> TAGATCTACAATAATATGA
ATAGCCATCTCTTGTAACC -> TAGCCATCTCTTGTAACCC
ATAGCGATGATTATCCAAT -> TAGCGATGATTATCCAATT
ATAGCTAGTGAGACTCTAC -> TAGCTAGTGAGACTCTACA
ATAGCTGTTGAGAGATAGT -> TAGCTGTTGAGAGATAGTG
ATAGTCCATAGATCTACAA -> TAGTCCATAGATCTACAAT
ATAGTCGTACAGTGTTACG -> TAGTCGTACAGTGTTACGA
ATAGTCGTCGGAGGTGCGT -> TAGTCGTCGGAGGTGCGTG
ATAGTGGTCATTTGTCACT -> TAGTGGTCATTTGTCACTT
ATAGTTGCTCTCTGGGCTC -> TAGTTGCTCTCTGGGCTCT
ATAGTTTAGTAGGTCTTCT -> TAGTTTAGTAGGTCTTCTA
ATATAAAAAGTATTTTTCT -> TATAAAAAGTATTTTTCTA
ATATAAGGAGGGGGGTCCT -> TATAAGGAGGGGGGTCCTC
ATATAATGCCGACCTAGCT -> TATAATGCCGACCTAGCTG
ATATACTCCACAGAGGTCT -> TATACTCCACAGAGGTCTA
ATATACTTTATTGCCCAGC -> TATACTTTATTGCCCAGCC
ATATAGCTAGTGAGACTCT -> TATAGCTAGTGAGACTCTA
ATATAGTCCATAGATCTAC -> TATAGTCCATAGATCTACA
ATATATAGTCCATAGATCT -> TATATAGTCCATAGATCTA
ATATATGTGTTCAAAGTTT -> TATATGTGTTCAAAGTTTT
ATATCAGATTGAGCAGTCC -> TATCAGATTGAGCAGTCCA
ATATGAGGCACAAGCTCTA -> TATGAGGCACAAGCTCTAA
ATATGAGGCACTAACGCAT -> TATGAGGCACTAACGCATA
ATATGAGGCACTGTCATTC -> TATGAGGCACTGTCATTCG
ATATGAGGCAGCTGAATAT -> TATGAGGCAGCTGAATATA
ATATGCCAGCCTCGTAGGC -> TATGCCAGCCTCGTAGGCC
ATATGTGTTCAAAGTTTTT -> TATGTGTTCAAAGTTTTTT
ATATGTTATACGGATTCTC -> TATGTTATACGGATTCTCG
ATATTAGGGTGCTAAAGGA -> TATTAGGGTGCTAAAGGAC
ATCAACGTCTGGATTGAGC -> TCAACGTCTGGATTGAGCG
ATCACAAAATCCAAAAATA -> TCACAAAATCCAAAAATAA
ATCACTAGGTTTGCCGGAG -> TCACTAGGTTTGCCGGAGA
ATCAGATTGAGCAGTCCAC -> TCAGATTGAGCAGTCCACA
ATCATAACTCAGGTAACGC -> TCATAACTCAGGTAACGCA
ATCATTAGAACTTGCATAG -> TCATTAGAACTTGCATAGC
ATCCAAAAATAAGACTACG -> TCCAAAAATAAGACTACGG
ATCCAACAGCGGCGTTAAA -> TCCAACAGCGGCGTTAAAC
ATCCAATTCCACTTAAGGG -> TCCAATTCCACTTAAGGGC
ATCCCTCTGTGGCACTTGT -> TCCCTCTGTGGCACTTGTT
ATCCGCCTAGGTGTTGCCG -> TCCGCCTAGGTGTTGCCGA
ATCCGCGTATAGCGATGAT -> TCCGCGTATAGCGATGATT
ATCGAAGGGTCCAAGCACG -> TCGAAGGGTCCAAGCACGG
ATCGAAGTGTCGATTTCCT -> TCGAAGTGTCGATTTCCTT
ATCGATTGCCGATAGTCGT -> TCGATTGCCGATAGTCGTA
ATCGTTGGTAGCTAGATAT -> TCGTTGGTAGCTAGATATA
ATCTAAACACTCCATATGC -> TCTAAACACTCCATATGCC
ATCTACAATAATATGAGGC -> TCTACAATAATATGAGGCA
ATCTACAGAATTGACTTGC -> TCTACAGAATTGACTTGCA
ATCTCACAATTTAAAGAAA -> TCTCACAATTTAAAGAAAC
ATCTCAGCTGAATATAAAA -> TCTCAGCTGAATATAAAAA
ATCTCAGCTGAATATAGCT -> TCTCAGCTGAATATAGCTA
ATCTCAGCTGAATATATAG -> TCTCAGCTGAATATATAGT
ATCTCATGGATCTCAGCTG -> TCTCATGGATCTCAGCTGA
ATCTCGATCCGCGTATAGC -> TCTCGATCCGCGTATAGCG
ATCTCTTGTAACCCTCGTT -> TCTCTTGTAACCCTCGTTT
ATCTGTATCGTTGGTAGCT -> TCTGTATCGTTGGTAGCTA
ATCTTCGATTGATGAGCCC -> TCTTCGATTGATGAGCCCA
ATCTTCGCTACGATGTTCT -> TCTTCGCTACGATGTTCTG
ATCTTTTTGCGTCGCTTAG -> TCTTTTTGCGTCGCTTAGA
ATGAACCACAGATTTTTTT -> TGAACCACAGATTTTTTTG
ATGACAATATGTTATACGG -> TGACAATATGTTATACGGA
ATGAGCCCAGTCTTAAACC -> TGAGCCCAGTCTTAAACCA
ATGAGGCACAAGCTCTAAA -> TGAGGCACAAGCTCTAAAG
ATGAGGCACTAACGCATAA -> TGAGGCACTAACGCATAAC
ATGAGGCACTGTCATTCGA -> TGAGGCACTGTCATTCGAA
ATGAGGCAGCTGAATATAC -> TGAGGCAGCTGAATATACT
ATGATTATCCAATTCCACT -> TGATTATCCAATTCCACTT
ATGCACCAAGCGTCTATCC -> TGCACCAAGCGTCTATCCA
ATGCAGCCTTACTGGATGG -> TGCAGCCTTACTGGATGGG
ATGCAGTTACGACTGATAT -> TGCAGTTACGACTGATATC
ATGCCAGCCTCGTAGGCCA -> TGCCAGCCTCGTAGGCCAG
ATGCCCATTAAACGCTGGT -> TGCCCATTAAACGCTGGTA
ATGCCGACCTAGCTGAACA -> TGCCGACCTAGCTGAACAG
ATGCCTCAACGGTACTGCG -> TGCCTCAACGGTACTGCGA
ATGCTAAAGACCATTTACT -> TGCTAAAGACCATTTACTT
ATGGAGTTCCTGTCCACAT -> TGGAGTTCCTGTCCACATG
ATGGATCTCAGCTGAATAT -> TGGATCTCAGCTGAATATA
ATGGGGAGAACTTCGTCGT -> TGGGGAGAACTTCGTCGTA
ATGGGTAGGCCCGCCCCTC -> TGGGTAGGCCCGCCCCTCA
ATGTACCTACGTCATACTC -> TGTACCTACGTCATACTCC
ATGTCGCAGGGGGGTACGT -> TGTCGCAGGGGGGTACGTT
ATGTGGTCCGTGTTGTTCG -> TGTGGTCCGTGTTGTTCGT
ATGTGTTCAAAGTTTTTTG -> TGTGTTCAAAGTTTTTTGC
ATGTTATACGGATTCTCGA -> TGTTATACGGATTCTCGAG
ATGTTCTGCCGACGCATCC -> TGTTCTGCCGACGCATCCG
ATGTTGCATGCCTCAACGG -> TGTTGCATGCCTCAACGGT
ATTAAACGCTGGTAGGTGG -> TTAAACGCTGGTAGGTGGC
ATTACGTCGCTCAAGTTAA -> TTACGTCGCTCAAGTTAAT
ATTAGAACTTGCATAGCTG -> TTAGAACTTGCATAGCTGT
ATTAGGGTGCTAAAGGACT -> TTAGGGTGCTAAAGGACTC
ATTAGGTGTTTCGTTTAAA -> TTAGGTGTTTCGTTTAAAG
ATTATCCAATTCCACTTAA -> TTATCCAATTCCACTTAAG
ATTCATACGGGCGGGACCC -> TTCATACGGGCGGGACCCG
ATTCCACTTAAGGGCGAAT -> TTCCACTTAAGGGCGAATA
ATTCCCGGGCTTGTTCGCT -> TTCCCGGGCTTGTTCGCTC
ATTCCTTTATCTAAACACT -> TTCCTTTATCTAAACACTC
ATTCGAATACTCAGCCCAA -> TTCGAATACTCAGCCCAAA
ATTCGCCTCCGCCTTTCGA -> TTCGCCTCCGCCTTTCGAG
ATTCTCGAGGTAGTCAATT -> TTCTCGAGGTAGTCAATTG
ATTCTTTCGTTGTTGAGAA -> TTCTTTCGTTGTTGAGAAT
ATTGACTTGCATGTTGCAT -> TTGACTTGCATGTTGCATG
ATTGAGCAGTCCACAACAT -> TTGAGCAGTCCACAACATA
ATTGAGCGGTAGGAGCGGA -> TTGAGCGGTAGGAGCGGAA
ATTGATGAGCCCAGTCTTA -> TTGATGAGCCCAGTCTTAA
ATTGCATTGTATTCATACG -> TTGCATTGTATTCATACGG
ATTGCCCAGCCCACTCATC -> TTGCCCAGCCCACTCATCG
ATTGCCGATAGTCGTACAG -> TTGCCGATAGTCGTACAGT
ATTGCGCGTCCAGCTTGTG -> TTGCGCGTCCAGCTTGTGC
ATTGGGTCGATGACAATAT -> TTGGGTCGATGACAATATG
ATTGTATCCCTCTGTGGCA -> TTGTATCCCTCTGTGGCAC
ATTGTATTCATACGGGCGG -> TTGTATTCATACGGGCGGG
ATTTAAAGAAACGGTTGAC -> TTTAAAGAAACGGTTGACT
ATTTACACGCTTTGGTTTC -> TTTACACGCTTTGGTTTCC
ATTTACTTGCCTACATAGA -> TTTACTTGCCTACATAGAA
ATTTAGACGACACCCTATA -> TTTAGACGACACCCTATAC
ATTTAGATTGCATTGTATT -> TTTAGATTGCATTGTATTC
ATTTAGGTAGATTTAGATT -> TTTAGGTAGATTTAGATTG
ATTTCCTTGCTCTACAACT -> TTTCCTTGCTCTACAACTA
ATTTGGGCGGACAGCGGCC -> TTTGGGCGGACAGCGGCCG
ATTTGTCACTTCCAGCCGT -> TTTGTCACTTCCAGCCGTA
ATTTTCCGGTGATATACTT -> TTTTCCGGTGATATACTTT
ATTTTTCTACAATAATATG -> TTTTTCTACAATAATATGA
ATTTTTTTGTAAGAGTGAT -> TTTTTTTGTAAGAGTGATC
CAAAAATAAGACTACGGCG -> AAAAATAAGACTACGGCGC
CAAAACGGCACCTCATGTC -> AAAACGGCACCTCATGTCG
CAAAATCCAAAAATAAGAC -> AAAATCCAAAAATAAGACT
CAAAGATTTTCCGGTGATA -> AAAGATTTTCCGGTGATAT
CAAAGGATCTCAGCTGAAT -> AAAGGATCTCAGCTGAATA
CAAAGTTTTTTGCTCCTCG -> AAAGTTTTTTGCTCCTCGG
CAACAGCGGCGTTAAACCG -> AACAGCGGCGTTAAACCGA
CAACATAACGTACGGATCT -> AACATAACGTACGGATCTC
CAACCGGGTCCAGGAAGTA -> AACCGGGTCCAGGAAGTAA
CAACCGGTCTGCCCACATA -> AACCGGTCTGCCCACATAA
CAACGGTACTGCGATTTAC -> AACGGTACTGCGATTTACA
CAACGTCTGGATTGAGCGG -> AACGTCTGGATTGAGCGGT
CAACTACTTCTGTTCGCGA -> AACTACTTCTGTTCGCGAA
CAAGACCATCGAAGTGTCG -> AAGACCATCGAAGTGTCGA
CAAGCACGGACGCGTAATA -> AAGCACGGACGCGTAATAA
CAAGCGTCTATCCAACAGC -> AAGCGTCTATCCAACAGCG
CAAGCTCTAAAGGATCAAC -> AAGCTCTAAAGGATCAACG
CAAGTGTCGCCGGGGTTTT -> AAGTGTCGCCGGGGTTTTG
CAAGTTAATTCGCCTCCGC -> AAGTTAATTCGCCTCCGCC
CAATAATATGAGGCACAAG -> AATAATATGAGGCACAAGC
CAATAATATGAGGCACTAA -> AATAATATGAGGCACTAAC
CAATAATATGAGGCACTGT -> AATAATATGAGGCACTGTC
CAATAATATGAGGCAGCTG -> AATAATATGAGGCAGCTGA
CAATACAAGTGTCGCCGGG -> AATACAAGTGTCGCCGGGG
CAATACAGAAGCCCTGGGA -> AATACAGAAGCCCTGGGAA
CAATATGTTATACGGATTC -> AATATGTTATACGGATTCT
CAATCACTAGGTTTGCCGG -> AATCACTAGGTTTGCCGGA
CAATCATAACTCAGGTAAC -> AATCATAACTCAGGTAACG
CAATTCCACTTAAGGGCGA -> AATTCCACTTAAGGGCGAA
CAATTGTATCCCTCTGTGG -> AATTGTATCCCTCTGTGGC
CAATTTAAAGAAACGGTTG -> AATTTAAAGAAACGGTTGA
CACAAAATCCAAAAATAAG -> ACAAAATCCAAAAATAAGA
CACAACATAACGTACGGAT -> ACAACATAACGTACGGATC
CACAAGCTCTAAAGGATCA -> ACAAGCTCTAAAGGATCAA
CACAATTTAAAGAAACGGT -> ACAATTTAAAGAAACGGTT
CACAGAGGTCTACAATAAT -> ACAGAGGTCTACAATAATA
CACAGATTTTTTTGTAAGA -> ACAGATTTTTTTGTAAGAG
CACATAAATTGGGTCGATG -> ACATAAATTGGGTCGATGA
CACATGCAGCCTTACTGGA -> ACATGCAGCCTTACTGGAT
CACCAAGCGTCTATCCAAC -> ACCAAGCGTCTATCCAACA
CACCCATATTAGGGTGCTA -> ACCCATATTAGGGTGCTAA
CACCCCCCTATAACCCTGG -> ACCCCCCTATAACCCTGGA
CACCCTATACAGGGATCTC -> ACCCTATACAGGGATCTCA
CACCTCAACCGGTCTGCCC -> ACCTCAACCGGTCTGCCCA
CACCTCATGTCGCAGGGGG -> ACCTCATGTCGCAGGGGGG
CACGAACTCATTCCCGGGC -> ACGAACTCATTCCCGGGCT
CACGCTTTGGTTTCCGCGG -> ACGCTTTGGTTTCCGCGGA
CACGGACGCGTAATAAGGA -> ACGGACGCGTAATAAGGAC
CACTAACGCATAACAGGGA -> ACTAACGCATAACAGGGAG
CACTAGGTTTGCCGGAGAT -> ACTAGGTTTGCCGGAGATC
CACTCATCGATTGCCGATA -> ACTCATCGATTGCCGATAG
CACTCCATATGCCAGCCTC -> ACTCCATATGCCAGCCTCG
CACTGTCATTCGAATACTC -> ACTGTCATTCGAATACTCA
CACTGTTGCCAATACAGAA -> ACTGTTGCCAATACAGAAG
CACTTAAGGGCGAATAGTC -> ACTTAAGGGCGAATAGTCG
CACTTCCAGCCGTAGCTAA -> ACTTCCAGCCGTAGCTAAA
CACTTGAGATAACTGATAA -> ACTTGAGATAACTGATAAG
CACTTGTTGCGCATTTAGA -> ACTTGTTGCGCATTTAGAC
CAGAAGCCCTGGGAAGATG -> AGAAGCCCTGGGAAGATGA
CAGAATTGACTTGCATGTT -> AGAATTGACTTGCATGTTG
CAGACATGCACCAAGCGTC -> AGACATGCACCAAGCGTCT
CAGAGGTCTACAATAATAT -> AGAGGTCTACAATAATATG
CAGAGTGACAGTGAACTTA -> AGAGTGACAGTGAACTTAA
CAGATAGACCACGAACTCA -> AGATAGACCACGAACTCAT
CAGATTACGTCGCTCAAGT -> AGATTACGTCGCTCAAGTT
CAGATTGAGCAGTCCACAA -> AGATTGAGCAGTCCACAAC
CAGATTTTTTTGTAAGAGT -> AGATTTTTTTGTAAGAGTG
CAGCCCAAAGGATCTCAGC -> AGCCCAAAGGATCTCAGCT
CAGCCCACTCATCGATTGC -> AGCCCACTCATCGATTGCC
CAGCCGTAGCTAAAGAGTG -> AGCCGTAGCTAAAGAGTGC
CAGCCTCGTAGGCCAGCTC -> AGCCTCGTAGGCCAGCTCT
CAGCCTTACTGGATGGGTA -> AGCCTTACTGGATGGGTAG
CAGCGAGCTATGGGGAGAA -> AGCGAGCTATGGGGAGAAC
CAGCGGCCGTGATCTTTTT -> AGCGGCCGTGATCTTTTTG
CAGCGGCGTTAAACCGATC -> AGCGGCGTTAAACCGATCT
CAGCTAACAATCACTAGGT -> AGCTAACAATCACTAGGTT
CAGCTCTCAAGACCATCGA -> AGCTCTCAAGACCATCGAA
CAGCTGAATATAAAAAGTA -> AGCTGAATATAAAAAGTAT
CAGCTGAATATACTCCACA -> AGCTGAATATACTCCACAG
CAGCTGAATATAGCTAGTG -> AGCTGAATATAGCTAGTGA
CAGCTGAATATATAGTCCA -> AGCTGAATATATAGTCCAT
CAGCTTGTGCGTACAATCA -> AGCTTGTGCGTACAATCAT
CAGGAAGTAAGAGGGGGTT -> AGGAAGTAAGAGGGGGTTG
CAGGGAGACCTAGAATTTG -> AGGGAGACCTAGAATTTGG
CAGGGATCTCAGCTGAATA -> AGGGATCTCAGCTGAATAT
CAGGGGGGTACGTTGTGGC -> AGGGGGGTACGTTGTGGCA
CAGGGGTGTAATGCCCATT -> AGGGGTGTAATGCCCATTA
CAGGTAACGCAGTGCATTT -> AGGTAACGCAGTGCATTTA
CAGTCCACAACATAACGTA -> AGTCCACAACATAACGTAC
CAGTCTTAAACCAGGGGTG -> AGTCTTAAACCAGGGGTGT
CAGTGAACTTAAGAAATAG -> AGTGAACTTAAGAAATAGA
CAGTGCATTTAGGTAGATT -> AGTGCATTTAGGTAGATTT
CAGTGGGAATGTACCTACG -> AGTGGGAATGTACCTACGT
CAGTGTTACGACGCGACCT -> AGTGTTACGACGCGACCTT
CAGTTACGACTGATATCAG -> AGTTACGACTGATATCAGA
CAGTTTAATCACAAAATCC -> AGTTTAATCACAAAATCCA
CATAAATTGGGTCGATGAC -> ATAAATTGGGTCGATGACA
CATAACAGGGAGACCTAGA -> ATAACAGGGAGACCTAGAA
CATAACGTACGGATCTCAT -> ATAACGTACGGATCTCATG
CATAACTCAGGTAACGCAG -> ATAACTCAGGTAACGCAGT
CATACGGGCGGGACCCGCT -> ATACGGGCGGGACCCGCTC
CATACTCCAGATTACGTCG -> ATACTCCAGATTACGTCGC
CATAGAACATATATGTGTT -> ATAGAACATATATGTGTTC
CATAGATCTACAATAATAT -> ATAGATCTACAATAATATG
CATAGCTGTTGAGAGATAG -> ATAGCTGTTGAGAGATAGT
CATATATGTGTTCAAAGTT -> ATATATGTGTTCAAAGTTT
CATATGCCAGCCTCGTAGG -> ATATGCCAGCCTCGTAGGC
CATATTAGGGTGCTAAAGG -> ATATTAGGGTGCTAAAGGA
CATCCGCCTAGGTGTTGCC -> ATCCGCCTAGGTGTTGCCG
CATCGAAGTGTCGATTTCC -> ATCGAAGTGTCGATTTCCT
CATCGATTGCCGATAGTCG -> ATCGATTGCCGATAGTCGT
CATCTCTTGTAACCCTCGT -> ATCTCTTGTAACCCTCGTT
CATCTTCGATTGATGAGCC -> ATCTTCGATTGATGAGCCC
CATGCACCAAGCGTCTATC -> ATGCACCAAGCGTCTATCC
CATGCAGCCTTACTGGATG -> ATGCAGCCTTACTGGATGG
CATGCCTCAACGGTACTGC -> ATGCCTCAACGGTACTGCG
CATGGATCTCAGCTGAATA -> ATGGATCTCAGCTGAATAT
CATGTCGCAGGGGGGTACG -> ATGTCGCAGGGGGGTACGT
CATGTGGTCCGTGTTGTTC -> ATGTGGTCCGTGTTGTTCG
CATGTTGCATGCCTCAACG -> ATGTTGCATGCCTCAACGG
CATTAAACGCTGGTAGGTG -> ATTAAACGCTGGTAGGTGG
CATTAGAACTTGCATAGCT -> ATTAGAACTTGCATAGCTG
CATTCCCGGGCTTGTTCGC -> ATTCCCGGGCTTGTTCGCT
CATTCGAATACTCAGCCCA -> ATTCGAATACTCAGCCCAA
CATTGTATTCATACGGGCG -> ATTGTATTCATACGGGCGG
CATTTACTTGCCTACATAG -> ATTTACTTGCCTACATAGA
CATTTAGACGACACCCTAT -> ATTTAGACGACACCCTATA
CATTTAGGTAGATTTAGAT -> ATTTAGGTAGATTTAGATT
CATTTGTCACTTCCAGCCG -> ATTTGTCACTTCCAGCCGT
CCAAAAATAAGACTACGGC -> CAAAAATAAGACTACGGCG
CCAAAGGATCTCAGCTGAA -> CAAAGGATCTCAGCTGAAT
CCAACAGCGGCGTTAAACC -> CAACAGCGGCGTTAAACCG
CCAAGCACGGACGCGTAAT -> CAAGCACGGACGCGTAATA
CCAAGCGTCTATCCAACAG -> CAAGCGTCTATCCAACAGC
CCAATACAAGTGTCGCCGG -> CAATACAAGTGTCGCCGGG
CCAATACAGAAGCCCTGGG -> CAATACAGAAGCCCTGGGA
CCAATTCCACTTAAGGGCG -> CAATTCCACTTAAGGGCGA
CCACAACATAACGTACGGA -> CACAACATAACGTACGGAT
CCACAGAGGTCTACAATAA -> CACAGAGGTCTACAATAAT
CCACAGATTTTTTTGTAAG -> CACAGATTTTTTTGTAAGA
CCACATAAATTGGGTCGAT -> CACATAAATTGGGTCGATG
CCACATGCAGCCTTACTGG -> CACATGCAGCCTTACTGGA
CCACCCATATTAGGGTGCT -> CACCCATATTAGGGTGCTA
CCACGAACTCATTCCCGGG -> CACGAACTCATTCCCGGGC
CCACTCATCGATTGCCGAT -> CACTCATCGATTGCCGATA
CCACTTAAGGGCGAATAGT -> CACTTAAGGGCGAATAGTC
CCACTTGAGATAACTGATA -> CACTTGAGATAACTGATAA
CCAGAGTGACAGTGAACTT -> CAGAGTGACAGTGAACTTA
CCAGATAGACCACGAACTC -> CAGATAGACCACGAACTCA
CCAGATTACGTCGCTCAAG -> CAGATTACGTCGCTCAAGT
CCAGCCCACTCATCGATTG -> CAGCCCACTCATCGATTGC
CCAGCCGTAGCTAAAGAGT -> CAGCCGTAGCTAAAGAGTG
CCAGCCTCGTAGGCCAGCT -> CAGCCTCGTAGGCCAGCTC
CCAGCGAGCTATGGGGAGA -> CAGCGAGCTATGGGGAGAA
CCAGCTCTCAAGACCATCG -> CAGCTCTCAAGACCATCGA
CCAGCTTGTGCGTACAATC -> CAGCTTGTGCGTACAATCA
CCAGGAAGTAAGAGGGGGT -> CAGGAAGTAAGAGGGGGTT
CCAGGGGTGTAATGCCCAT -> CAGGGGTGTAATGCCCATT
CCAGTCTTAAACCAGGGGT -> CAGTCTTAAACCAGGGGTG
CCAGTTTAATCACAAAATC -> CAGTTTAATCACAAAATCC
CCATAGATCTACAATAATA -> CATAGATCTACAATAATAT
CCATATGCCAGCCTCGTAG -> CATATGCCAGCCTCGTAGG
CCATATTAGGGTGCTAAAG -> CATATTAGGGTGCTAAAGG
CCATCGAAGTGTCGATTTC -> CATCGAAGTGTCGATTTCC
CCATCTCTTGTAACCCTCG -> CATCTCTTGTAACCCTCGT
CCATCTTCGATTGATGAGC -> CATCTTCGATTGATGAGCC
CCATTAAACGCTGGTAGGT -> CATTAAACGCTGGTAGGTG
CCATTTACTTGCCTACATA -> CATTTACTTGCCTACATAG
CCCAAAGGATCTCAGCTGA -> CCAAAGGATCTCAGCTGAA
CCCACATAAATTGGGTCGA -> CCACATAAATTGGGTCGAT
CCCACCCATATTAGGGTGC -> CCACCCATATTAGGGTGCT
CCCACTCATCGATTGCCGA -> CCACTCATCGATTGCCGAT
CCCACTTGAGATAACTGAT -> CCACTTGAGATAACTGATA
CCCAGAGTGACAGTGAACT -> CCAGAGTGACAGTGAACTT
CCCAGCCCACTCATCGATT -> CCAGCCCACTCATCGATTG
CCCAGTCTTAAACCAGGGG -> CCAGTCTTAAACCAGGGGT
CCCATATTAGGGTGCTAAA -> CCATATTAGGGTGCTAAAG
CCCATTAAACGCTGGTAGG -> CCATTAAACGCTGGTAGGT
CCCCCCTATAACCCTGGAA -> CCCCCTATAACCCTGGAAT
CCCCCTATAACCCTGGAAT -> CCCCTATAACCCTGGAATT
CCCCCTTGCCTCCCTAGAG -> CCCCTTGCCTCCCTAGAGG
CCCCTATAACCCTGGAATT -> CCCTATAACCCTGGAATTC
CCCCTCACCTCAACCGGTC -> CCCTCACCTCAACCGGTCT
CCCCTTGCCTCCCTAGAGG -> CCCTTGCCTCCCTAGAGGT
CCCGCCCCTCACCTCAACC -> CCGCCCCTCACCTCAACCG
CCCGCTCGCTCCTGAACGT -> CCGCTCGCTCCTGAACGTG
CCCGGGCTTGTTCGCTCTG -> CCGGGCTTGTTCGCTCTGA
CCCTAGAGGTCATGTGGTC -> CCTAGAGGTCATGTGGTCC
CCCTATAACCCTGGAATTC -> CCTATAACCCTGGAATTCT
CCCTATACAGGGATCTCAG -> CCTATACAGGGATCTCAGC
CCCTATATAAGGAGGGGGG -> CCTATATAAGGAGGGGGGT
CCCTCACCTCAACCGGTCT -> CCTCACCTCAACCGGTCTG
CCCTCGTTTACGTAGGCTG -> CCTCGTTTACGTAGGCTGT
CCCTCTGTGGCACTTGTTG -> CCTCTGTGGCACTTGTTGC
CCCTGGAATTCTTTCGTTG -> CCTGGAATTCTTTCGTTGT
CCCTGGGAAGATGAACCAC -> CCTGGGAAGATGAACCACA
CCCTTGCCTCCCTAGAGGT -> CCTTGCCTCCCTAGAGGTC
CCGACAGTGGGAATGTACC -> CGACAGTGGGAATGTACCT
CCGACCTAGCTGAACAGCT -> CGACCTAGCTGAACAGCTA
CCGACGCATCCGCCTAGGT -> CGACGCATCCGCCTAGGTG
CCGACTGGGCGTCGGGGTT -> CGACTGGGCGTCGGGGTTG
CCGAGTCCGATCGAAGGGT -> CGAGTCCGATCGAAGGGTC
CCGATAGTCGTACAGTGTT -> CGATAGTCGTACAGTGTTA
CCGATCGAAGGGTCCAAGC -> CGATCGAAGGGTCCAAGCA
CCGATCTGTATCGTTGGTA -> CGATCTGTATCGTTGGTAG
CCGCCAGCGAGCTATGGGG -> CGCCAGCGAGCTATGGGGA
CCGCCCCTCACCTCAACCG -> CGCCCCTCACCTCAACCGG
CCGCCTAGGTGTTGCCGAC -> CGCCTAGGTGTTGCCGACT
CCGCCTTTCGAGAGGAGTG -> CGCCTTTCGAGAGGAGTGT
CCGCGCCCACCCATATTAG -> CGCGCCCACCCATATTAGG
CCGCGGAGTAAACTCCCTA -> CGCGGAGTAAACTCCCTAT
CCGCGTATAGCGATGATTA -> CGCGTATAGCGATGATTAT
CCGCTCGCTCCTGAACGTG -> CGCTCGCTCCTGAACGTGT
CCGGAGATCTTCGCTACGA -> CGGAGATCTTCGCTACGAT
CCGGCCAGTTTAATCACAA -> CGGCCAGTTTAATCACAAA
CCGGGCTTGTTCGCTCTGA -> CGGGCTTGTTCGCTCTGAT
CCGGGGTTTTGTATGCAGT -> CGGGGTTTTGTATGCAGTT
CCGGGTCCAGGAAGTAAGA -> CGGGTCCAGGAAGTAAGAG
CCGGTCTGCCCACATAAAT -> CGGTCTGCCCACATAAATT
CCGGTGATATACTTTATTG -> CGGTGATATACTTTATTGC
CCGTAGCTAAAGAGTGCAA -> CGTAGCTAAAGAGTGCAAC
CCGTGATCTTTTTGCGTCG -> CGTGATCTTTTTGCGTCGC
CCGTGTTGTTCGTAGCCGC -> CGTGTTGTTCGTAGCCGCG
CCTACATAGAACATATATG -> CTACATAGAACATATATGT
CCTACGTCATACTCCAGAT -> CTACGTCATACTCCAGATT
CCTAGAATTTGGGCGGACA -> CTAGAATTTGGGCGGACAG
CCTAGAGGTCATGTGGTCC -> CTAGAGGTCATGTGGTCCG
CCTAGCTGAACAGCTAACA -> CTAGCTGAACAGCTAACAA
CCTAGGTGTTGCCGACTGG -> CTAGGTGTTGCCGACTGGG
CCTATAACCCTGGAATTCT -> CTATAACCCTGGAATTCTT
CCTATACAGGGATCTCAGC -> CTATACAGGGATCTCAGCT
CCTATATAAGGAGGGGGGT -> CTATATAAGGAGGGGGGTC
CCTCAACCGGTCTGCCCAC -> CTCAACCGGTCTGCCCACA
CCTCAACGGTACTGCGATT -> CTCAACGGTACTGCGATTT
CCTCACCTCAACCGGTCTG -> CTCACCTCAACCGGTCTGC
CCTCATGTCGCAGGGGGGT -> CTCATGTCGCAGGGGGGTA
CCTCCCTAGAGGTCATGTG -> CTCCCTAGAGGTCATGTGG
CCTCCGCCTTTCGAGAGGA -> CTCCGCCTTTCGAGAGGAG
CCTCGGCCAATACAAGTGT -> CTCGGCCAATACAAGTGTC
CCTCGTAGGCCAGCTCTCA -> CTCGTAGGCCAGCTCTCAA
CCTCGTTTACGTAGGCTGT -> CTCGTTTACGTAGGCTGTC
CCTCTGTGGCACTTGTTGC -> CTCTGTGGCACTTGTTGCG
CCTCTTTGTGCCCAGAGTG -> CTCTTTGTGCCCAGAGTGA
CCTGAACGTGTATCTCGAT -> CTGAACGTGTATCTCGATC
CCTGGAATTCTTTCGTTGT -> CTGGAATTCTTTCGTTGTT
CCTGGGAAGATGAACCACA -> CTGGGAAGATGAACCACAG
CCTGTCCACATGCAGCCTT -> CTGTCCACATGCAGCCTTA
CCTTACTGGATGGGTAGGC -> CTTACTGGATGGGTAGGCC
CCTTCTATAGTTGCTCTCT -> CTTCTATAGTTGCTCTCTG
CCTTCTCCCCCTTGCCTCC -> CTTCTCCCCCTTGCCTCCC
CCTTGCCTCCCTAGAGGTC -> CTTGCCTCCCTAGAGGTCA
CCTTGCTCTACAACTACTT -> CTTGCTCTACAACTACTTC
CCTTTATCTAAACACTCCA -> CTTTATCTAAACACTCCAT
CCTTTCGAGAGGAGTGTTC -> CTTTCGAGAGGAGTGTTCG
CGAACTCATTCCCGGGCTT -> GAACTCATTCCCGGGCTTG
CGAAGCCGGCCAGTTTAAT -> GAAGCCGGCCAGTTTAATC
CGAAGCGAATTCCTTTATC -> GAAGCGAATTCCTTTATCT
CGAAGGGTCCAAGCACGGA -> GAAGGGTCCAAGCACGGAC
CGAAGTGTCGATTTCCTTG -> GAAGTGTCGATTTCCTTGC
CGAATACTCAGCCCAAAGG -> GAATACTCAGCCCAAAGGA
CGAATAGTCGTCGGAGGTG -> GAATAGTCGTCGGAGGTGC
CGAATGCTAAAGACCATTT -> GAATGCTAAAGACCATTTA
CGAATTCCTTTATCTAAAC -> GAATTCCTTTATCTAAACA
CGACACCCTATACAGGGAT -> GACACCCTATACAGGGATC
CGACAGTGGGAATGTACCT -> GACAGTGGGAATGTACCTA
CGACCTAGCTGAACAGCTA -> GACCTAGCTGAACAGCTAA
CGACCTTCTCCCCCTTGCC -> GACCTTCTCCCCCTTGCCT
CGACGCATCCGCCTAGGTG -> GACGCATCCGCCTAGGTGT
CGACGCGACCTTCTCCCCC -> GACGCGACCTTCTCCCCCT
CGACTAGTGATTAGGTGTT -> GACTAGTGATTAGGTGTTT
CGACTGATATCAGATTGAG -> GACTGATATCAGATTGAGC
CGACTGGGCGTCGGGGTTG -> GACTGGGCGTCGGGGTTGC
CGAGAGGAGTGTTCGAGTT -> GAGAGGAGTGTTCGAGTTG
CGAGCTATGGGGAGAACTT -> GAGCTATGGGGAGAACTTC
CGAGGTAGTCAATTGTATC -> GAGGTAGTCAATTGTATCC
CGAGTCCGATCGAAGGGTC -> GAGTCCGATCGAAGGGTCC
CGAGTTGACCAGATAGACC -> GAGTTGACCAGATAGACCA
CGATACGAATGCTAAAGAC -> GATACGAATGCTAAAGACC
CGATAGTCGTACAGTGTTA -> GATAGTCGTACAGTGTTAC
CGATCCGCGTATAGCGATG -> GATCCGCGTATAGCGATGA
CGATCGAAGGGTCCAAGCA -> GATCGAAGGGTCCAAGCAC
CGATCTGTATCGTTGGTAG -> GATCTGTATCGTTGGTAGC
CGATGACAATATGTTATAC -> GATGACAATATGTTATACG
CGATGATTATCCAATTCCA -> GATGATTATCCAATTCCAC
CGATGGAGTTCCTGTCCAC -> GATGGAGTTCCTGTCCACA
CGATGTTCTGCCGACGCAT -> GATGTTCTGCCGACGCATC
CGATTGATGAGCCCAGTCT -> GATTGATGAGCCCAGTCTT
CGATTGCCGATAGTCGTAC -> GATTGCCGATAGTCGTACA
CGATTGCGCGTCCAGCTTG -> GATTGCGCGTCCAGCTTGT
CGATTTACACGCTTTGGTT -> GATTTACACGCTTTGGTTT
CGATTTCCTTGCTCTACAA -> GATTTCCTTGCTCTACAAC
CGCAAAGATTTTCCGGTGA -> GCAAAGATTTTCCGGTGAT
CGCAGGGGGGTACGTTGTG -> GCAGGGGGGTACGTTGTGG
CGCAGTGCATTTAGGTAGA -> GCAGTGCATTTAGGTAGAT
CGCATAACAGGGAGACCTA -> GCATAACAGGGAGACCTAG
CGCATCCGCCTAGGTGTTG -> GCATCCGCCTAGGTGTTGC
CGCATTTAGACGACACCCT -> GCATTTAGACGACACCCTA
CGCCAGCGAGCTATGGGGA -> GCCAGCGAGCTATGGGGAG
CGCCCACCCATATTAGGGT -> GCCCACCCATATTAGGGTG
CGCCCCTCACCTCAACCGG -> GCCCCTCACCTCAACCGGT
CGCCGAGTCCGATCGAAGG -> GCCGAGTCCGATCGAAGGG
CGCCGGGGTTTTGTATGCA -> GCCGGGGTTTTGTATGCAG
CGCCTAGGTGTTGCCGACT -> GCCTAGGTGTTGCCGACTG
CGCCTCCGCCTTTCGAGAG -> GCCTCCGCCTTTCGAGAGG
CGCCTTTCGAGAGGAGTGT -> GCCTTTCGAGAGGAGTGTT
CGCGAAGCCGGCCAGTTTA -> GCGAAGCCGGCCAGTTTAA
CGCGACCTTCTCCCCCTTG -> GCGACCTTCTCCCCCTTGC
CGCGACTAGTGATTAGGTG -> GCGACTAGTGATTAGGTGT
CGCGCCCACCCATATTAGG -> GCGCCCACCCATATTAGGG
CGCGGAGTAAACTCCCTAT -> GCGGAGTAAACTCCCTATA
CGCGTAATAAGGACCATCT -> GCGTAATAAGGACCATCTT
CGCGTATAGCGATGATTAT -> GCGTATAGCGATGATTATC
CGCGTCCAGCTTGTGCGTA -> GCGTCCAGCTTGTGCGTAC
CGCTAATCATTAGAACTTG -> GCTAATCATTAGAACTTGC
CGCTACGATGTTCTGCCGA -> GCTACGATGTTCTGCCGAC
CGCTCAAGTTAATTCGCCT -> GCTCAAGTTAATTCGCCTC
CGCTCCTGAACGTGTATCT -> GCTCCTGAACGTGTATCTC
CGCTCGCTCCTGAACGTGT -> GCTCGCTCCTGAACGTGTA
CGCTCTGATAGCCATCTCT -> GCTCTGATAGCCATCTCTT
CGCTGGTAGGTGGCCTTCT -> GCTGGTAGGTGGCCTTCTA
CGCTTAGAACTGCTTTACT -> GCTTAGAACTGCTTTACTG
CGCTTTGGTTTCCGCGGAG -> GCTTTGGTTTCCGCGGAGT
CGGAAGGACAAAACGGCAC -> GGAAGGACAAAACGGCACC
CGGACAGCGGCCGTGATCT -> GGACAGCGGCCGTGATCTT
CGGACGCGTAATAAGGACC -> GGACGCGTAATAAGGACCA
CGGAGATCTTCGCTACGAT -> GGAGATCTTCGCTACGATG
CGGAGGTGCGTGTTTACGA -> GGAGGTGCGTGTTTACGAA
CGGAGTAAACTCCCTATAT -> GGAGTAAACTCCCTATATA
CGGATCTCATGGATCTCAG -> GGATCTCATGGATCTCAGC
CGGATTCTCGAGGTAGTCA -> GGATTCTCGAGGTAGTCAA
CGGCACCTCATGTCGCAGG -> GGCACCTCATGTCGCAGGG
CGGCCAATACAAGTGTCGC -> GGCCAATACAAGTGTCGCC
CGGCCAGTTTAATCACAAA -> GGCCAGTTTAATCACAAAA
CGGCCGTGATCTTTTTGCG -> GGCCGTGATCTTTTTGCGT
CGGCGCTAATCATTAGAAC -> GGCGCTAATCATTAGAACT
CGGCGTTAAACCGATCTGT -> GGCGTTAAACCGATCTGTA
CGGGACCCGCTCGCTCCTG -> GGGACCCGCTCGCTCCTGA
CGGGCGGGACCCGCTCGCT -> GGGCGGGACCCGCTCGCTC
CGGGCTTGTTCGCTCTGAT -> GGGCTTGTTCGCTCTGATA
CGGGGTTGCCGACAGTGGG -> GGGGTTGCCGACAGTGGGA
CGGGGTTTTGTATGCAGTT -> GGGGTTTTGTATGCAGTTA
CGGGTCCAGGAAGTAAGAG -> GGGTCCAGGAAGTAAGAGG
CGGTACTGCGATTTACACG -> GGTACTGCGATTTACACGC
CGGTAGGAGCGGAAGGACA -> GGTAGGAGCGGAAGGACAA
CGGTCTGCCCACATAAATT -> GGTCTGCCCACATAAATTG
CGGTGATATACTTTATTGC -> GGTGATATACTTTATTGCC
CGGTTGACTTCGCAAAGAT -> GGTTGACTTCGCAAAGATT
CGTAACGTTTTAAGGACTC -> GTAACGTTTTAAGGACTCG
CGTAATAAGGACCATCTTC -> GTAATAAGGACCATCTTCG
CGTACAATCATAACTCAGG -> GTACAATCATAACTCAGGT
CGTACAGTGTTACGACGCG -> GTACAGTGTTACGACGCGA
CGTACGGATCTCATGGATC -> GTACGGATCTCATGGATCT
CGTACGTCGATTGCGCGTC -> GTACGTCGATTGCGCGTCC
CGTAGCCGCGCCCACCCAT -> GTAGCCGCGCCCACCCATA
CGTAGCTAAAGAGTGCAAC -> GTAGCTAAAGAGTGCAACC
CGTAGGCCAGCTCTCAAGA -> GTAGGCCAGCTCTCAAGAC
CGTAGGCTGTCGCGACTAG -> GTAGGCTGTCGCGACTAGT
CGTATAGCGATGATTATCC -> GTATAGCGATGATTATCCA
CGTCATACTCCAGATTACG -> GTCATACTCCAGATTACGT
CGTCCAGCTTGTGCGTACA -> GTCCAGCTTGTGCGTACAA
CGTCGATTGCGCGTCCAGC -> GTCGATTGCGCGTCCAGCT
CGTCGCTCAAGTTAATTCG -> GTCGCTCAAGTTAATTCGC
CGTCGCTTAGAACTGCTTT -> GTCGCTTAGAACTGCTTTA
CGTCGGAGGTGCGTGTTTA -> GTCGGAGGTGCGTGTTTAC
CGTCGGGGTTGCCGACAGT -> GTCGGGGTTGCCGACAGTG
CGTCGTAACGTTTTAAGGA -> GTCGTAACGTTTTAAGGAC
CGTCTATCCAACAGCGGCG -> GTCTATCCAACAGCGGCGT
CGTCTGGATTGAGCGGTAG -> GTCTGGATTGAGCGGTAGG
CGTCTTACGATGGAGTTCC -> GTCTTACGATGGAGTTCCT
CGTGATCTTTTTGCGTCGC -> GTGATCTTTTTGCGTCGCT
CGTGTATCTCGATCCGCGT -> GTGTATCTCGATCCGCGTA
CGTGTTGTTCGTAGCCGCG -> GTGTTGTTCGTAGCCGCGC
CGTGTTTACGAAGCGAATT -> GTGTTTACGAAGCGAATTC
CGTTAAACCGATCTGTATC -> GTTAAACCGATCTGTATCG
CGTTGGTAGCTAGATATAA -> GTTGGTAGCTAGATATAAT
CGTTGTGGCACTGTTGCCA -> GTTGTGGCACTGTTGCCAA
CGTTGTTGAGAATAGTTTA -> GTTGTTGAGAATAGTTTAG
CGTTTAAAGCTCGCCGAGT -> GTTTAAAGCTCGCCGAGTC
CGTTTACGTAGGCTGTCGC -> GTTTACGTAGGCTGTCGCG
CGTTTTAAGGACTCGTCTT -> GTTTTAAGGACTCGTCTTA
CTAAACACTCCATATGCCA -> TAAACACTCCATATGCCAG
CTAAAGACCATTTACTTGC -> TAAAGACCATTTACTTGCC
CTAAAGAGTGCAACCGGGT -> TAAAGAGTGCAACCGGGTC
CTAAAGGACTCAGACATGC -> TAAAGGACTCAGACATGCA
CTAAAGGATCAACGTCTGG -> TAAAGGATCAACGTCTGGA
CTAACAATCACTAGGTTTG -> TAACAATCACTAGGTTTGC
CTAACGCATAACAGGGAGA -> TAACGCATAACAGGGAGAC
CTAATCATTAGAACTTGCA -> TAATCATTAGAACTTGCAT
CTAATCTACAGAATTGACT -> TAATCTACAGAATTGACTT
CTACAACTACTTCTGTTCG -> TACAACTACTTCTGTTCGC
CTACAATAATATGAGGCAC -> TACAATAATATGAGGCACA,TACAATAATATGAGGCACT,TACAATAATATGAGGCACT
CTACAATAATATGAGGCAG -> TACAATAATATGAGGCAGC
CTACAGAATTGACTTGCAT -> TACAGAATTGACTTGCATG
CTACATAGAACATATATGT -> TACATAGAACATATATGTG
CTACGATGTTCTGCCGACG -> TACGATGTTCTGCCGACGC
CTACGGCGCTAATCATTAG -> TACGGCGCTAATCATTAGA
CTACGTCATACTCCAGATT -> TACGTCATACTCCAGATTA
CTACTTCTGTTCGCGAAGC -> TACTTCTGTTCGCGAAGCC
CTAGAATTTGGGCGGACAG -> TAGAATTTGGGCGGACAGC
CTAGAGGTCATGTGGTCCG -> TAGAGGTCATGTGGTCCGT
CTAGATATAATGCCGACCT -> TAGATATAATGCCGACCTA
CTAGCTGAACAGCTAACAA -> TAGCTGAACAGCTAACAAT
CTAGGTGTTGCCGACTGGG -> TAGGTGTTGCCGACTGGGC
CTAGGTTTGCCGGAGATCT -> TAGGTTTGCCGGAGATCTT
CTAGTGAGACTCTACAATA -> TAGTGAGACTCTACAATAA
CTAGTGATTAGGTGTTTCG -> TAGTGATTAGGTGTTTCGT
CTATAACCCTGGAATTCTT -> TATAACCCTGGAATTCTTT
CTATACAGGGATCTCAGCT -> TATACAGGGATCTCAGCTG
CTATAGTTGCTCTCTGGGC -> TATAGTTGCTCTCTGGGCT
CTATATAAGGAGGGGGGTC -> TATATAAGGAGGGGGGTCC
CTATCCAACAGCGGCGTTA -> TATCCAACAGCGGCGTTAA
CTATGGGGAGAACTTCGTC -> TATGGGGAGAACTTCGTCG
CTCAACCGGTCTGCCCACA -> TCAACCGGTCTGCCCACAT
CTCAACGGTACTGCGATTT -> TCAACGGTACTGCGATTTA
CTCAAGACCATCGAAGTGT -> TCAAGACCATCGAAGTGTC
CTCAAGTTAATTCGCCTCC -> TCAAGTTAATTCGCCTCCG
CTCACAATTTAAAGAAACG -> TCACAATTTAAAGAAACGG
CTCACCTCAACCGGTCTGC -> TCACCTCAACCGGTCTGCC
CTCAGACATGCACCAAGCG -> TCAGACATGCACCAAGCGT
CTCAGCCCAAAGGATCTCA -> TCAGCCCAAAGGATCTCAG
CTCAGCTGAATATAAAAAG -> TCAGCTGAATATAAAAAGT
CTCAGCTGAATATAGCTAG -> TCAGCTGAATATAGCTAGT
CTCAGCTGAATATATAGTC -> TCAGCTGAATATATAGTCC
CTCAGGTAACGCAGTGCAT -> TCAGGTAACGCAGTGCATT
CTCATCGATTGCCGATAGT -> TCATCGATTGCCGATAGTC
CTCATGGATCTCAGCTGAA -> TCATGGATCTCAGCTGAAT
CTCATGTCGCAGGGGGGTA -> TCATGTCGCAGGGGGGTAC
CTCATTCCCGGGCTTGTTC -> TCATTCCCGGGCTTGTTCG
CTCCACAGAGGTCTACAAT -> TCCACAGAGGTCTACAATA
CTCCAGATTACGTCGCTCA -> TCCAGATTACGTCGCTCAA
CTCCATATGCCAGCCTCGT -> TCCATATGCCAGCCTCGTA
CTCCCCCTTGCCTCCCTAG -> TCCCCCTTGCCTCCCTAGA
CTCCCTAGAGGTCATGTGG -> TCCCTAGAGGTCATGTGGT
CTCCCTATATAAGGAGGGG -> TCCCTATATAAGGAGGGGG
CTCCGCCTTTCGAGAGGAG -> TCCGCCTTTCGAGAGGAGT
CTCCTCGGCCAATACAAGT -> TCCTCGGCCAATACAAGTG
CTCCTGAACGTGTATCTCG -> TCCTGAACGTGTATCTCGA
CTCGAGGTAGTCAATTGTA -> TCGAGGTAGTCAATTGTAT
CTCGATCCGCGTATAGCGA -> TCGATCCGCGTATAGCGAT
CTCGCCGAGTCCGATCGAA -> TCGCCGAGTCCGATCGAAG
CTCGCTCCTGAACGTGTAT -> TCGCTCCTGAACGTGTATC
CTCGGCCAATACAAGTGTC -> TCGGCCAATACAAGTGTCG
CTCGTAGGCCAGCTCTCAA -> TCGTAGGCCAGCTCTCAAG
CTCGTCTTACGATGGAGTT -> TCGTCTTACGATGGAGTTC
CTCGTTTACGTAGGCTGTC -> TCGTTTACGTAGGCTGTCG
CTCTAAAGGATCAACGTCT -> TCTAAAGGATCAACGTCTG
CTCTACAACTACTTCTGTT -> TCTACAACTACTTCTGTTC
CTCTACAATAATATGAGGC -> TCTACAATAATATGAGGCA
CTCTCAAGACCATCGAAGT -> TCTCAAGACCATCGAAGTG
CTCTCTGGGCTCTGGCACC -> TCTCTGGGCTCTGGCACCC
CTCTGATAGCCATCTCTTG -> TCTGATAGCCATCTCTTGT
CTCTGGCACCCCCCTATAA -> TCTGGCACCCCCCTATAAC
CTCTGGGCTCTGGCACCCC -> TCTGGGCTCTGGCACCCCC
CTCTGTGGCACTTGTTGCG -> TCTGTGGCACTTGTTGCGC
CTCTTGTAACCCTCGTTTA -> TCTTGTAACCCTCGTTTAC
CTCTTTGTGCCCAGAGTGA -> TCTTTGTGCCCAGAGTGAC
CTGAACAGCTAACAATCAC -> TGAACAGCTAACAATCACT
CTGAACGTGTATCTCGATC -> TGAACGTGTATCTCGATCC
CTGAATATAAAAAGTATTT -> TGAATATAAAAAGTATTTT
CTGAATATACTCCACAGAG -> TGAATATACTCCACAGAGG
CTGAATATAGCTAGTGAGA -> TGAATATAGCTAGTGAGAC
CTGAATATATAGTCCATAG -> TGAATATATAGTCCATAGA
CTGATAAGCCGCCAGCGAG -> TGATAAGCCGCCAGCGAGC
CTGATAGCCATCTCTTGTA -> TGATAGCCATCTCTTGTAA
CTGATATCAGATTGAGCAG -> TGATATCAGATTGAGCAGT
CTGCCCACATAAATTGGGT -> TGCCCACATAAATTGGGTC
CTGCCGACGCATCCGCCTA -> TGCCGACGCATCCGCCTAG
CTGCGATTTACACGCTTTG -> TGCGATTTACACGCTTTGG
CTGCTTTACTGTTCGATAC -> TGCTTTACTGTTCGATACG
CTGGAATTCTTTCGTTGTT -> TGGAATTCTTTCGTTGTTG
CTGGATGGGTAGGCCCGCC -> TGGATGGGTAGGCCCGCCC
CTGGATTGAGCGGTAGGAG -> TGGATTGAGCGGTAGGAGC
CTGGCACCCCCCTATAACC -> TGGCACCCCCCTATAACCC
CTGGGAAGATGAACCACAG -> TGGGAAGATGAACCACAGA
CTGGGCGTCGGGGTTGCCG -> TGGGCGTCGGGGTTGCCGA
CTGGGCTCTGGCACCCCCC -> TGGGCTCTGGCACCCCCCT
CTGGTAGGTGGCCTTCTAT -> TGGTAGGTGGCCTTCTATA
CTGTATCGTTGGTAGCTAG -> TGTATCGTTGGTAGCTAGA
CTGTCATTCGAATACTCAG -> TGTCATTCGAATACTCAGC
CTGTCCACATGCAGCCTTA -> TGTCCACATGCAGCCTTAC
CTGTCGCGACTAGTGATTA -> TGTCGCGACTAGTGATTAG
CTGTGGCACTTGTTGCGCA -> TGTGGCACTTGTTGCGCAT
CTGTTCGATACGAATGCTA -> TGTTCGATACGAATGCTAA
CTGTTCGCGAAGCCGGCCA -> TGTTCGCGAAGCCGGCCAG
CTGTTGAGAGATAGTGGTC -> TGTTGAGAGATAGTGGTCA
CTGTTGCCAATACAGAAGC -> TGTTGCCAATACAGAAGCC
CTTAAACCAGGGGTGTAAT -> TTAAACCAGGGGTGTAATG
CTTAAGAAATAGAACCTTG -> TTAAGAAATAGAACCTTGC
CTTAAGGGCGAATAGTCGT -> TTAAGGGCGAATAGTCGTC
CTTACGATGGAGTTCCTGT -> TTACGATGGAGTTCCTGTC
CTTACTGGATGGGTAGGCC -> TTACTGGATGGGTAGGCCC
CTTAGAACTGCTTTACTGT -> TTAGAACTGCTTTACTGTT
CTTCCAGCCGTAGCTAAAG -> TTCCAGCCGTAGCTAAAGA
CTTCGATTGATGAGCCCAG -> TTCGATTGATGAGCCCAGT
CTTCGCAAAGATTTTCCGG -> TTCGCAAAGATTTTCCGGT
CTTCGCTACGATGTTCTGC -> TTCGCTACGATGTTCTGCC
CTTCGTCGTAACGTTTTAA -> TTCGTCGTAACGTTTTAAG
CTTCTAATCTACAGAATTG -> TTCTAATCTACAGAATTGA
CTTCTATAGTTGCTCTCTG -> TTCTATAGTTGCTCTCTGG
CTTCTCCCCCTTGCCTCCC -> TTCTCCCCCTTGCCTCCCT
CTTCTGTTCGCGAAGCCGG -> TTCTGTTCGCGAAGCCGGC
CTTGAGATAACTGATAAGC -> TTGAGATAACTGATAAGCC
CTTGCATAGCTGTTGAGAG -> TTGCATAGCTGTTGAGAGA
CTTGCATGTTGCATGCCTC -> TTGCATGTTGCATGCCTCA
CTTGCCTACATAGAACATA -> TTGCCTACATAGAACATAT
CTTGCCTCCCTAGAGGTCA -> TTGCCTCCCTAGAGGTCAT
CTTGCTCTACAACTACTTC -> TTGCTCTACAACTACTTCT
CTTGTAACCCTCGTTTACG -> TTGTAACCCTCGTTTACGT
CTTGTGCGTACAATCATAA -> TTGTGCGTACAATCATAAC
CTTGTTCGCTCTGATAGCC -> TTGTTCGCTCTGATAGCCA
CTTGTTGCGCATTTAGACG -> TTGTTGCGCATTTAGACGA
CTTTACTGTTCGATACGAA -> TTTACTGTTCGATACGAAT
CTTTATCTAAACACTCCAT -> TTTATCTAAACACTCCATA
CTTTATTGCCCAGCCCACT -> TTTATTGCCCAGCCCACTC
CTTTCGAGAGGAGTGTTCG -> TTTCGAGAGGAGTGTTCGA
CTTTCGTTGTTGAGAATAG -> TTTCGTTGTTGAGAATAGT
CTTTGGTTTCCGCGGAGTA -> TTTGGTTTCCGCGGAGTAA
CTTTGTGCCCAGAGTGACA -> TTTGTGCCCAGAGTGACAG
CTTTTTGCGTCGCTTAGAA -> TTTTTGCGTCGCTTAGAAC
GAAACGGTTGACTTCGCAA -> AAACGGTTGACTTCGCAAA
GAACAGCTAACAATCACTA -> AACAGCTAACAATCACTAG
GAACATATATGTGTTCAAA -> AACATATATGTGTTCAAAG
GAACCACAGATTTTTTTGT -> AACCACAGATTTTTTTGTA
GAACGTGTATCTCGATCCG -> AACGTGTATCTCGATCCGC
GAACTCATTCCCGGGCTTG -> AACTCATTCCCGGGCTTGT
GAACTGCTTTACTGTTCGA -> AACTGCTTTACTGTTCGAT
GAACTTAAGAAATAGAACC -> AACTTAAGAAATAGAACCT
GAACTTCGTCGTAACGTTT -> AACTTCGTCGTAACGTTTT
GAACTTGCATAGCTGTTGA -> AACTTGCATAGCTGTTGAG
GAAGATGAACCACAGATTT -> AAGATGAACCACAGATTTT
GAAGCCCTGGGAAGATGAA -> AAGCCCTGGGAAGATGAAC
GAAGCCGGCCAGTTTAATC -> AAGCCGGCCAGTTTAATCA
GAAGCGAATTCCTTTATCT -> AAGCGAATTCCTTTATCTA
GAAGGACAAAACGGCACCT -> AAGGACAAAACGGCACCTC
GAAGGGTCCAAGCACGGAC -> AAGGGTCCAAGCACGGACG
GAAGTAAGAGGGGGTTGCC -> AAGTAAGAGGGGGTTGCCC
GAAGTGTCGATTTCCTTGC -> AAGTGTCGATTTCCTTGCT
GAATACTCAGCCCAAAGGA -> AATACTCAGCCCAAAGGAT
GAATAGTCGTCGGAGGTGC -> AATAGTCGTCGGAGGTGCG
GAATAGTTTAGTAGGTCTT -> AATAGTTTAGTAGGTCTTC
GAATATAAAAAGTATTTTT -> AATATAAAAAGTATTTTTC
GAATATACTCCACAGAGGT -> AATATACTCCACAGAGGTC
GAATATAGCTAGTGAGACT -> AATATAGCTAGTGAGACTC
GAATATATAGTCCATAGAT -> AATATATAGTCCATAGATC
GAATGCTAAAGACCATTTA -> AATGCTAAAGACCATTTAC
GAATGTACCTACGTCATAC -> AATGTACCTACGTCATACT
GAATTCCTTTATCTAAACA -> AATTCCTTTATCTAAACAC
GAATTCTTTCGTTGTTGAG -> AATTCTTTCGTTGTTGAGA
GAATTGACTTGCATGTTGC -> AATTGACTTGCATGTTGCA
GAATTTGGGCGGACAGCGG -> AATTTGGGCGGACAGCGGC
GACAAAACGGCACCTCATG -> ACAAAACGGCACCTCATGT
GACAATATGTTATACGGAT -> ACAATATGTTATACGGATT
GACACCCTATACAGGGATC -> ACACCCTATACAGGGATCT
GACAGCGGCCGTGATCTTT -> ACAGCGGCCGTGATCTTTT
GACAGTGAACTTAAGAAAT -> ACAGTGAACTTAAGAAATA
GACAGTGGGAATGTACCTA -> ACAGTGGGAATGTACCTAC
GACATGCACCAAGCGTCTA -> ACATGCACCAAGCGTCTAT
GACCACGAACTCATTCCCG -> ACCACGAACTCATTCCCGG
GACCAGATAGACCACGAAC -> ACCAGATAGACCACGAACT
GACCATCGAAGTGTCGATT -> ACCATCGAAGTGTCGATTT
GACCATCTTCGATTGATGA -> ACCATCTTCGATTGATGAG
GACCATTTACTTGCCTACA -> ACCATTTACTTGCCTACAT
GACCCGCTCGCTCCTGAAC -> ACCCGCTCGCTCCTGAACG
GACCTAGAATTTGGGCGGA -> ACCTAGAATTTGGGCGGAC
GACCTAGCTGAACAGCTAA -> ACCTAGCTGAACAGCTAAC
GACCTTCTCCCCCTTGCCT -> ACCTTCTCCCCCTTGCCTC
GACGACACCCTATACAGGG -> ACGACACCCTATACAGGGA
GACGCATCCGCCTAGGTGT -> ACGCATCCGCCTAGGTGTT
GACGCGACCTTCTCCCCCT -> ACGCGACCTTCTCCCCCTT
GACGCGTAATAAGGACCAT -> ACGCGTAATAAGGACCATC
GACTACGGCGCTAATCATT -> ACTACGGCGCTAATCATTA
GACTAGTGATTAGGTGTTT -> ACTAGTGATTAGGTGTTTC
GACTCAGACATGCACCAAG -> ACTCAGACATGCACCAAGC
GACTCGTCTTACGATGGAG -> ACTCGTCTTACGATGGAGT
GACTCTACAATAATATGAG -> ACTCTACAATAATATGAGG
GACTGATATCAGATTGAGC -> ACTGATATCAGATTGAGCA
GACTGGGCGTCGGGGTTGC -> ACTGGGCGTCGGGGTTGCC
GACTTCGCAAAGATTTTCC -> ACTTCGCAAAGATTTTCCG
GACTTGCATGTTGCATGCC -> ACTTGCATGTTGCATGCCT
GAGAACTTCGTCGTAACGT -> AGAACTTCGTCGTAACGTT
GAGAATAGTTTAGTAGGTC -> AGAATAGTTTAGTAGGTCT
GAGACCTAGAATTTGGGCG -> AGACCTAGAATTTGGGCGG
GAGACTCTACAATAATATG -> AGACTCTACAATAATATGA
GAGAGATAGTGGTCATTTG -> AGAGATAGTGGTCATTTGT
GAGAGGAGTGTTCGAGTTG -> AGAGGAGTGTTCGAGTTGA
GAGATAACTGATAAGCCGC -> AGATAACTGATAAGCCGCC
GAGATAGTGGTCATTTGTC -> AGATAGTGGTCATTTGTCA
GAGATCTTCGCTACGATGT -> AGATCTTCGCTACGATGTT
GAGCAGTCCACAACATAAC -> AGCAGTCCACAACATAACG
GAGCCCAGTCTTAAACCAG -> AGCCCAGTCTTAAACCAGG
GAGCGGAAGGACAAAACGG -> AGCGGAAGGACAAAACGGC
GAGCGGTAGGAGCGGAAGG -> AGCGGTAGGAGCGGAAGGA
GAGCTATGGGGAGAACTTC -> AGCTATGGGGAGAACTTCG
GAGGAGTGTTCGAGTTGAC -> AGGAGTGTTCGAGTTGACC
GAGGCACAAGCTCTAAAGG -> AGGCACAAGCTCTAAAGGA
GAGGCACTAACGCATAACA -> AGGCACTAACGCATAACAG
GAGGCACTGTCATTCGAAT -> AGGCACTGTCATTCGAATA
GAGGCAGCTGAATATACTC -> AGGCAGCTGAATATACTCC
GAGGGGGGTCCTCTTTGTG -> AGGGGGGTCCTCTTTGTGC
GAGGGGGTTGCCCACTTGA -> AGGGGGTTGCCCACTTGAG
GAGGTAGTCAATTGTATCC -> AGGTAGTCAATTGTATCCC
GAGGTCATGTGGTCCGTGT -> AGGTCATGTGGTCCGTGTT
GAGGTCTACAATAATATGA -> AGGTCTACAATAATATGAG
GAGGTGCGTGTTTACGAAG -> AGGTGCGTGTTTACGAAGC
GAGTAAACTCCCTATATAA -> AGTAAACTCCCTATATAAG
GAGTCCGATCGAAGGGTCC -> AGTCCGATCGAAGGGTCCA
GAGTGACAGTGAACTTAAG -> AGTGACAGTGAACTTAAGA
GAGTGATCTCACAATTTAA -> AGTGATCTCACAATTTAAA
GAGTGCAACCGGGTCCAGG -> AGTGCAACCGGGTCCAGGA
GAGTGTTCGAGTTGACCAG -> AGTGTTCGAGTTGACCAGA
GAGTTCCTGTCCACATGCA -> AGTTCCTGTCCACATGCAG
GAGTTGACCAGATAGACCA -> AGTTGACCAGATAGACCAC
GATAACTGATAAGCCGCCA -> ATAACTGATAAGCCGCCAG
GATAAGCCGCCAGCGAGCT -> ATAAGCCGCCAGCGAGCTA
GATACGAATGCTAAAGACC -> ATACGAATGCTAAAGACCA
GATAGACCACGAACTCATT -> ATAGACCACGAACTCATTC
GATAGCCATCTCTTGTAAC -> ATAGCCATCTCTTGTAACC
GATAGTCGTACAGTGTTAC -> ATAGTCGTACAGTGTTACG
GATAGTGGTCATTTGTCAC -> ATAGTGGTCATTTGTCACT
GATATAATGCCGACCTAGC -> ATATAATGCCGACCTAGCT
GATATACTTTATTGCCCAG -> ATATACTTTATTGCCCAGC
GATATCAGATTGAGCAGTC -> ATATCAGATTGAGCAGTCC
GATCAACGTCTGGATTGAG -> ATCAACGTCTGGATTGAGC
GATCCGCGTATAGCGATGA -> ATCCGCGTATAGCGATGAT
GATCGAAGGGTCCAAGCAC -> ATCGAAGGGTCCAAGCACG
GATCTACAATAATATGAGG -> ATCTACAATAATATGAGGC
GATCTCACAATTTAAAGAA -> ATCTCACAATTTAAAGAAA
GATCTCAGCTGAATATAAA -> ATCTCAGCTGAATATAAAA
GATCTCAGCTGAATATAGC -> ATCTCAGCTGAATATAGCT
GATCTCAGCTGAATATATA -> ATCTCAGCTGAATATATAG
GATCTCATGGATCTCAGCT -> ATCTCATGGATCTCAGCTG
GATCTGTATCGTTGGTAGC -> ATCTGTATCGTTGGTAGCT
GATCTTCGCTACGATGTTC -> ATCTTCGCTACGATGTTCT
GATCTTTTTGCGTCGCTTA -> ATCTTTTTGCGTCGCTTAG
GATGAACCACAGATTTTTT -> ATGAACCACAGATTTTTTT
GATGACAATATGTTATACG -> ATGACAATATGTTATACGG
GATGAGCCCAGTCTTAAAC -> ATGAGCCCAGTCTTAAACC
GATGATTATCCAATTCCAC -> ATGATTATCCAATTCCACT
GATGGAGTTCCTGTCCACA -> ATGGAGTTCCTGTCCACAT
GATGGGTAGGCCCGCCCCT -> ATGGGTAGGCCCGCCCCTC
GATGTTCTGCCGACGCATC -> ATGTTCTGCCGACGCATCC
GATTACGTCGCTCAAGTTA -> ATTACGTCGCTCAAGTTAA
GATTAGGTGTTTCGTTTAA -> ATTAGGTGTTTCGTTTAAA
GATTATCCAATTCCACTTA -> ATTATCCAATTCCACTTAA
GATTCTCGAGGTAGTCAAT -> ATTCTCGAGGTAGTCAATT
GATTGAGCAGTCCACAACA -> ATTGAGCAGTCCACAACAT
GATTGAGCGGTAGGAGCGG -> ATTGAGCGGTAGGAGCGGA
GATTGATGAGCCCAGTCTT -> ATTGATGAGCCCAGTCTTA
GATTGCATTGTATTCATAC -> ATTGCATTGTATTCATACG
GATTGCCGATAGTCGTACA -> ATTGCCGATAGTCGTACAG
GATTGCGCGTCCAGCTTGT -> ATTGCGCGTCCAGCTTGTG
GATTTACACGCTTTGGTTT -> ATTTACACGCTTTGGTTTC
GATTTAGATTGCATTGTAT -> ATTTAGATTGCATTGTATT
GATTTCCTTGCTCTACAAC -> ATTTCCTTGCTCTACAACT
GATTTTCCGGTGATATACT -> ATTTTCCGGTGATATACTT
GATTTTTTTGTAAGAGTGA -> ATTTTTTTGTAAGAGTGAT
GCAAAGATTTTCCGGTGAT -> CAAAGATTTTCCGGTGATA
GCAACCGGGTCCAGGAAGT -> CAACCGGGTCCAGGAAGTA
GCACAAGCTCTAAAGGATC -> CACAAGCTCTAAAGGATCA
GCACCAAGCGTCTATCCAA -> CACCAAGCGTCTATCCAAC
GCACCCCCCTATAACCCTG -> CACCCCCCTATAACCCTGG
GCACCTCATGTCGCAGGGG -> CACCTCATGTCGCAGGGGG
GCACGGACGCGTAATAAGG -> CACGGACGCGTAATAAGGA
GCACTAACGCATAACAGGG -> CACTAACGCATAACAGGGA
GCACTGTCATTCGAATACT -> CACTGTCATTCGAATACTC
GCACTGTTGCCAATACAGA -> CACTGTTGCCAATACAGAA
GCACTTGTTGCGCATTTAG -> CACTTGTTGCGCATTTAGA
GCAGCCTTACTGGATGGGT -> CAGCCTTACTGGATGGGTA
GCAGCTGAATATACTCCAC -> CAGCTGAATATACTCCACA
GCAGGGGGGTACGTTGTGG -> CAGGGGGGTACGTTGTGGC
GCAGTCCACAACATAACGT -> CAGTCCACAACATAACGTA
GCAGTGCATTTAGGTAGAT -> CAGTGCATTTAGGTAGATT
GCAGTTACGACTGATATCA -> CAGTTACGACTGATATCAG
GCATAACAGGGAGACCTAG -> CATAACAGGGAGACCTAGA
GCATAGCTGTTGAGAGATA -> CATAGCTGTTGAGAGATAG
GCATCCGCCTAGGTGTTGC -> CATCCGCCTAGGTGTTGCC
GCATGCCTCAACGGTACTG -> CATGCCTCAACGGTACTGC
GCATGTTGCATGCCTCAAC -> CATGTTGCATGCCTCAACG
GCATTGTATTCATACGGGC -> CATTGTATTCATACGGGCG
GCATTTAGACGACACCCTA -> CATTTAGACGACACCCTAT
GCATTTAGGTAGATTTAGA -> CATTTAGGTAGATTTAGAT
GCCAATACAAGTGTCGCCG -> CCAATACAAGTGTCGCCGG
GCCAATACAGAAGCCCTGG -> CCAATACAGAAGCCCTGGG
GCCAGCCTCGTAGGCCAGC -> CCAGCCTCGTAGGCCAGCT
GCCAGCGAGCTATGGGGAG -> CCAGCGAGCTATGGGGAGA
GCCAGCTCTCAAGACCATC -> CCAGCTCTCAAGACCATCG
GCCAGTTTAATCACAAAAT -> CCAGTTTAATCACAAAATC
GCCATCTCTTGTAACCCTC -> CCATCTCTTGTAACCCTCG
GCCCAAAGGATCTCAGCTG -> CCCAAAGGATCTCAGCTGA
GCCCACATAAATTGGGTCG -> CCCACATAAATTGGGTCGA
GCCCACCCATATTAGGGTG -> CCCACCCATATTAGGGTGC
GCCCACTCATCGATTGCCG -> CCCACTCATCGATTGCCGA
GCCCACTTGAGATAACTGA -> CCCACTTGAGATAACTGAT
GCCCAGAGTGACAGTGAAC -> CCCAGAGTGACAGTGAACT
GCCCAGCCCACTCATCGAT -> CCCAGCCCACTCATCGATT
GCCCAGTCTTAAACCAGGG -> CCCAGTCTTAAACCAGGGG
GCCCATTAAACGCTGGTAG -> CCCATTAAACGCTGGTAGG
GCCCCTCACCTCAACCGGT -> CCCCTCACCTCAACCGGTC
GCCCGCCCCTCACCTCAAC -> CCCGCCCCTCACCTCAACC
GCCCTGGGAAGATGAACCA -> CCCTGGGAAGATGAACCAC
GCCGACAGTGGGAATGTAC -> CCGACAGTGGGAATGTACC
GCCGACCTAGCTGAACAGC -> CCGACCTAGCTGAACAGCT
GCCGACGCATCCGCCTAGG -> CCGACGCATCCGCCTAGGT
GCCGACTGGGCGTCGGGGT -> CCGACTGGGCGTCGGGGTT
GCCGAGTCCGATCGAAGGG -> CCGAGTCCGATCGAAGGGT
GCCGATAGTCGTACAGTGT -> CCGATAGTCGTACAGTGTT
GCCGCCAGCGAGCTATGGG -> CCGCCAGCGAGCTATGGGG
GCCGCGCCCACCCATATTA -> CCGCGCCCACCCATATTAG
GCCGGAGATCTTCGCTACG -> CCGGAGATCTTCGCTACGA
GCCGGCCAGTTTAATCACA -> CCGGCCAGTTTAATCACAA
GCCGGGGTTTTGTATGCAG -> CCGGGGTTTTGTATGCAGT
GCCGTAGCTAAAGAGTGCA -> CCGTAGCTAAAGAGTGCAA
GCCGTGATCTTTTTGCGTC -> CCGTGATCTTTTTGCGTCG
GCCTACATAGAACATATAT -> CCTACATAGAACATATATG
GCCTAGGTGTTGCCGACTG -> CCTAGGTGTTGCCGACTGG
GCCTCAACGGTACTGCGAT -> CCTCAACGGTACTGCGATT
GCCTCCCTAGAGGTCATGT -> CCTCCCTAGAGGTCATGTG
GCCTCCGCCTTTCGAGAGG -> CCTCCGCCTTTCGAGAGGA
GCCTCGTAGGCCAGCTCTC -> CCTCGTAGGCCAGCTCTCA
GCCTTACTGGATGGGTAGG -> CCTTACTGGATGGGTAGGC
GCCTTCTATAGTTGCTCTC -> CCTTCTATAGTTGCTCTCT
GCCTTTCGAGAGGAGTGTT -> CCTTTCGAGAGGAGTGTTC
GCGAAGCCGGCCAGTTTAA -> CGAAGCCGGCCAGTTTAAT
GCGAATAGTCGTCGGAGGT -> CGAATAGTCGTCGGAGGTG
GCGAATTCCTTTATCTAAA -> CGAATTCCTTTATCTAAAC
GCGACCTTCTCCCCCTTGC -> CGACCTTCTCCCCCTTGCC
GCGACTAGTGATTAGGTGT -> CGACTAGTGATTAGGTGTT
GCGAGCTATGGGGAGAACT -> CGAGCTATGGGGAGAACTT
GCGATGATTATCCAATTCC -> CGATGATTATCCAATTCCA
GCGATTTACACGCTTTGGT -> CGATTTACACGCTTTGGTT
GCGCATTTAGACGACACCC -> CGCATTTAGACGACACCCT
GCGCCCACCCATATTAGGG -> CGCCCACCCATATTAGGGT
GCGCGTCCAGCTTGTGCGT -> CGCGTCCAGCTTGTGCGTA
GCGCTAATCATTAGAACTT -> CGCTAATCATTAGAACTTG
GCGGAAGGACAAAACGGCA -> CGGAAGGACAAAACGGCAC
GCGGACAGCGGCCGTGATC -> CGGACAGCGGCCGTGATCT
GCGGAGTAAACTCCCTATA -> CGGAGTAAACTCCCTATAT
GCGGCCGTGATCTTTTTGC -> CGGCCGTGATCTTTTTGCG
GCGGCGTTAAACCGATCTG -> CGGCGTTAAACCGATCTGT
GCGGGACCCGCTCGCTCCT -> CGGGACCCGCTCGCTCCTG
GCGGTAGGAGCGGAAGGAC -> CGGTAGGAGCGGAAGGACA
GCGTAATAAGGACCATCTT -> CGTAATAAGGACCATCTTC
GCGTACAATCATAACTCAG -> CGTACAATCATAACTCAGG
GCGTACGTCGATTGCGCGT -> CGTACGTCGATTGCGCGTC
GCGTATAGCGATGATTATC -> CGTATAGCGATGATTATCC
GCGTCCAGCTTGTGCGTAC -> CGTCCAGCTTGTGCGTACA
GCGTCGCTTAGAACTGCTT -> CGTCGCTTAGAACTGCTTT
GCGTCGGGGTTGCCGACAG -> CGTCGGGGTTGCCGACAGT
GCGTCTATCCAACAGCGGC -> CGTCTATCCAACAGCGGCG
GCGTGTTTACGAAGCGAAT -> CGTGTTTACGAAGCGAATT
GCGTTAAACCGATCTGTAT -> CGTTAAACCGATCTGTATC
GCTAAAGACCATTTACTTG -> CTAAAGACCATTTACTTGC
GCTAAAGAGTGCAACCGGG -> CTAAAGAGTGCAACCGGGT
GCTAAAGGACTCAGACATG -> CTAAAGGACTCAGACATGC
GCTAACAATCACTAGGTTT -> CTAACAATCACTAGGTTTG
GCTAATCATTAGAACTTGC -> CTAATCATTAGAACTTGCA
GCTACGATGTTCTGCCGAC -> CTACGATGTTCTGCCGACG
GCTAGATATAATGCCGACC -> CTAGATATAATGCCGACCT
GCTAGTGAGACTCTACAAT -> CTAGTGAGACTCTACAATA
GCTATGGGGAGAACTTCGT -> CTATGGGGAGAACTTCGTC
GCTCAAGTTAATTCGCCTC -> CTCAAGTTAATTCGCCTCC
GCTCCTCGGCCAATACAAG -> CTCCTCGGCCAATACAAGT
GCTCCTGAACGTGTATCTC -> CTCCTGAACGTGTATCTCG
GCTCGCCGAGTCCGATCGA -> CTCGCCGAGTCCGATCGAA
GCTCGCTCCTGAACGTGTA -> CTCGCTCCTGAACGTGTAT
GCTCTAAAGGATCAACGTC -> CTCTAAAGGATCAACGTCT
GCTCTACAACTACTTCTGT -> CTCTACAACTACTTCTGTT
GCTCTCAAGACCATCGAAG -> CTCTCAAGACCATCGAAGT
GCTCTCTGGGCTCTGGCAC -> CTCTCTGGGCTCTGGCACC
GCTCTGATAGCCATCTCTT -> CTCTGATAGCCATCTCTTG
GCTCTGGCACCCCCCTATA -> CTCTGGCACCCCCCTATAA
GCTGAACAGCTAACAATCA -> CTGAACAGCTAACAATCAC
GCTGAATATAAAAAGTATT -> CTGAATATAAAAAGTATTT
GCTGAATATACTCCACAGA -> CTGAATATACTCCACAGAG
GCTGAATATAGCTAGTGAG -> CTGAATATAGCTAGTGAGA
GCTGAATATATAGTCCATA -> CTGAATATATAGTCCATAG
GCTGGTAGGTGGCCTTCTA -> CTGGTAGGTGGCCTTCTAT
GCTGTCGCGACTAGTGATT -> CTGTCGCGACTAGTGATTA
GCTGTTGAGAGATAGTGGT -> CTGTTGAGAGATAGTGGTC
GCTTAGAACTGCTTTACTG -> CTTAGAACTGCTTTACTGT
GCTTGTGCGTACAATCATA -> CTTGTGCGTACAATCATAA
GCTTGTTCGCTCTGATAGC -> CTTGTTCGCTCTGATAGCC
GCTTTACTGTTCGATACGA -> CTTTACTGTTCGATACGAA
GCTTTGGTTTCCGCGGAGT -> CTTTGGTTTCCGCGGAGTA
GGAAGATGAACCACAGATT -> GAAGATGAACCACAGATTT
GGAAGGACAAAACGGCACC -> GAAGGACAAAACGGCACCT
GGAAGTAAGAGGGGGTTGC -> GAAGTAAGAGGGGGTTGCC
GGAATGTACCTACGTCATA -> GAATGTACCTACGTCATAC
GGAATTCTTTCGTTGTTGA -> GAATTCTTTCGTTGTTGAG
GGACAAAACGGCACCTCAT -> GACAAAACGGCACCTCATG
GGACAGCGGCCGTGATCTT -> GACAGCGGCCGTGATCTTT
GGACCATCTTCGATTGATG -> GACCATCTTCGATTGATGA
GGACCCGCTCGCTCCTGAA -> GACCCGCTCGCTCCTGAAC
GGACGCGTAATAAGGACCA -> GACGCGTAATAAGGACCAT
GGACTCAGACATGCACCAA -> GACTCAGACATGCACCAAG
GGACTCGTCTTACGATGGA -> GACTCGTCTTACGATGGAG
GGAGAACTTCGTCGTAACG -> GAGAACTTCGTCGTAACGT
GGAGACCTAGAATTTGGGC -> GAGACCTAGAATTTGGGCG
GGAGATCTTCGCTACGATG -> GAGATCTTCGCTACGATGT
GGAGCGGAAGGACAAAACG -> GAGCGGAAGGACAAAACGG
GGAGGGGGGTCCTCTTTGT -> GAGGGGGGTCCTCTTTGTG
GGAGGTGCGTGTTTACGAA -> GAGGTGCGTGTTTACGAAG
GGAGTAAACTCCCTATATA -> GAGTAAACTCCCTATATAA
GGAGTGTTCGAGTTGACCA -> GAGTGTTCGAGTTGACCAG
GGAGTTCCTGTCCACATGC -> GAGTTCCTGTCCACATGCA
GGATCAACGTCTGGATTGA -> GATCAACGTCTGGATTGAG
GGATCTCAGCTGAATATAA -> GATCTCAGCTGAATATAAA
GGATCTCAGCTGAATATAG -> GATCTCAGCTGAATATAGC
GGATCTCAGCTGAATATAT -> GATCTCAGCTGAATATATA
GGATCTCATGGATCTCAGC -> GATCTCATGGATCTCAGCT
GGATGGGTAGGCCCGCCCC -> GATGGGTAGGCCCGCCCCT
GGATTCTCGAGGTAGTCAA -> GATTCTCGAGGTAGTCAAT
GGATTGAGCGGTAGGAGCG -> GATTGAGCGGTAGGAGCGG
GGCACAAGCTCTAAAGGAT -> GCACAAGCTCTAAAGGATC
GGCACCCCCCTATAACCCT -> GCACCCCCCTATAACCCTG
GGCACCTCATGTCGCAGGG -> GCACCTCATGTCGCAGGGG
GGCACTAACGCATAACAGG -> GCACTAACGCATAACAGGG
GGCACTGTCATTCGAATAC -> GCACTGTCATTCGAATACT
GGCACTGTTGCCAATACAG -> GCACTGTTGCCAATACAGA
GGCACTTGTTGCGCATTTA -> GCACTTGTTGCGCATTTAG
GGCAGCTGAATATACTCCA -> GCAGCTGAATATACTCCAC
GGCCAATACAAGTGTCGCC -> GCCAATACAAGTGTCGCCG
GGCCAGCTCTCAAGACCAT -> GCCAGCTCTCAAGACCATC
GGCCAGTTTAATCACAAAA -> GCCAGTTTAATCACAAAAT
GGCCCGCCCCTCACCTCAA -> GCCCGCCCCTCACCTCAAC
GGCCGTGATCTTTTTGCGT -> GCCGTGATCTTTTTGCGTC
GGCCTTCTATAGTTGCTCT -> GCCTTCTATAGTTGCTCTC
GGCGAATAGTCGTCGGAGG -> GCGAATAGTCGTCGGAGGT
GGCGCTAATCATTAGAACT -> GCGCTAATCATTAGAACTT
GGCGGACAGCGGCCGTGAT -> GCGGACAGCGGCCGTGATC
GGCGGGACCCGCTCGCTCC -> GCGGGACCCGCTCGCTCCT
GGCGTCGGGGTTGCCGACA -> GCGTCGGGGTTGCCGACAG
GGCGTTAAACCGATCTGTA -> GCGTTAAACCGATCTGTAT
GGCTCTGGCACCCCCCTAT -> GCTCTGGCACCCCCCTATA
GGCTGTCGCGACTAGTGAT -> GCTGTCGCGACTAGTGATT
GGCTTGTTCGCTCTGATAG -> GCTTGTTCGCTCTGATAGC
GGGAAGATGAACCACAGAT -> GGAAGATGAACCACAGATT
GGGAATGTACCTACGTCAT -> GGAATGTACCTACGTCATA
GGGACCCGCTCGCTCCTGA -> GGACCCGCTCGCTCCTGAA
GGGAGAACTTCGTCGTAAC -> GGAGAACTTCGTCGTAACG
GGGAGACCTAGAATTTGGG -> GGAGACCTAGAATTTGGGC
GGGATCTCAGCTGAATATA -> GGATCTCAGCTGAATATAG
GGGCGAATAGTCGTCGGAG -> GGCGAATAGTCGTCGGAGG
GGGCGGACAGCGGCCGTGA -> GGCGGACAGCGGCCGTGAT
GGGCGGGACCCGCTCGCTC -> GGCGGGACCCGCTCGCTCC
GGGCGTCGGGGTTGCCGAC -> GGCGTCGGGGTTGCCGACA
GGGCTCTGGCACCCCCCTA -> GGCTCTGGCACCCCCCTAT
GGGCTTGTTCGCTCTGATA -> GGCTTGTTCGCTCTGATAG
GGGGAGAACTTCGTCGTAA -> GGGAGAACTTCGTCGTAAC
GGGGGGTACGTTGTGGCAC -> GGGGGTACGTTGTGGCACT
GGGGGGTCCTCTTTGTGCC -> GGGGGTCCTCTTTGTGCCC
GGGGGTACGTTGTGGCACT -> GGGGTACGTTGTGGCACTG
GGGGGTCCTCTTTGTGCCC -> GGGGTCCTCTTTGTGCCCA
GGGGGTTGCCCACTTGAGA -> GGGGTTGCCCACTTGAGAT
GGGGTACGTTGTGGCACTG -> GGGTACGTTGTGGCACTGT
GGGGTCCTCTTTGTGCCCA -> GGGTCCTCTTTGTGCCCAG
GGGGTGTAATGCCCATTAA -> GGGTGTAATGCCCATTAAA
GGGGTTGCCCACTTGAGAT -> GGGTTGCCCACTTGAGATA
GGGGTTGCCGACAGTGGGA -> GGGTTGCCGACAGTGGGAA
GGGGTTTTGTATGCAGTTA -> GGGTTTTGTATGCAGTTAC
GGGTACGTTGTGGCACTGT -> GGTACGTTGTGGCACTGTT
GGGTAGGCCCGCCCCTCAC -> GGTAGGCCCGCCCCTCACC
GGGTCCAAGCACGGACGCG -> GGTCCAAGCACGGACGCGT
GGGTCCAGGAAGTAAGAGG -> GGTCCAGGAAGTAAGAGGG
GGGTCCTCTTTGTGCCCAG -> GGTCCTCTTTGTGCCCAGA
GGGTCGATGACAATATGTT -> GGTCGATGACAATATGTTA
GGGTGCTAAAGGACTCAGA -> GGTGCTAAAGGACTCAGAC
GGGTGTAATGCCCATTAAA -> GGTGTAATGCCCATTAAAC
GGGTTGCCCACTTGAGATA -> GGTTGCCCACTTGAGATAA
GGGTTGCCGACAGTGGGAA -> GGTTGCCGACAGTGGGAAT
GGGTTTTGTATGCAGTTAC -> GGTTTTGTATGCAGTTACG
GGTAACGCAGTGCATTTAG -> GTAACGCAGTGCATTTAGG
GGTACGTTGTGGCACTGTT -> GTACGTTGTGGCACTGTTG
GGTACTGCGATTTACACGC -> GTACTGCGATTTACACGCT
GGTAGATTTAGATTGCATT -> GTAGATTTAGATTGCATTG
GGTAGCTAGATATAATGCC -> GTAGCTAGATATAATGCCG
GGTAGGAGCGGAAGGACAA -> GTAGGAGCGGAAGGACAAA
GGTAGGCCCGCCCCTCACC -> GTAGGCCCGCCCCTCACCT
GGTAGGTGGCCTTCTATAG -> GTAGGTGGCCTTCTATAGT
GGTAGTCAATTGTATCCCT -> GTAGTCAATTGTATCCCTC
GGTCATGTGGTCCGTGTTG -> GTCATGTGGTCCGTGTTGT
GGTCATTTGTCACTTCCAG -> GTCATTTGTCACTTCCAGC
GGTCCAAGCACGGACGCGT -> GTCCAAGCACGGACGCGTA
GGTCCAGGAAGTAAGAGGG -> GTCCAGGAAGTAAGAGGGG
GGTCCGTGTTGTTCGTAGC -> GTCCGTGTTGTTCGTAGCC
GGTCCTCTTTGTGCCCAGA -> GTCCTCTTTGTGCCCAGAG
GGTCGATGACAATATGTTA -> GTCGATGACAATATGTTAT
GGTCTACAATAATATGAGG -> GTCTACAATAATATGAGGC
GGTCTGCCCACATAAATTG -> GTCTGCCCACATAAATTGG
GGTCTTCTAATCTACAGAA -> GTCTTCTAATCTACAGAAT
GGTGATATACTTTATTGCC -> GTGATATACTTTATTGCCC
GGTGCGTGTTTACGAAGCG -> GTGCGTGTTTACGAAGCGA
GGTGCTAAAGGACTCAGAC -> GTGCTAAAGGACTCAGACA
GGTGGCCTTCTATAGTTGC -> GTGGCCTTCTATAGTTGCT
GGTGTAATGCCCATTAAAC -> GTGTAATGCCCATTAAACG
GGTGTTGCCGACTGGGCGT -> GTGTTGCCGACTGGGCGTC
GGTGTTTCGTTTAAAGCTC -> GTGTTTCGTTTAAAGCTCG
GGTTGACTTCGCAAAGATT -> GTTGACTTCGCAAAGATTT
GGTTGCCCACTTGAGATAA -> GTTGCCCACTTGAGATAAC
GGTTGCCGACAGTGGGAAT -> GTTGCCGACAGTGGGAATG
GGTTTCCGCGGAGTAAACT -> GTTTCCGCGGAGTAAACTC
GGTTTGCCGGAGATCTTCG -> GTTTGCCGGAGATCTTCGC
GGTTTTGTATGCAGTTACG -> GTTTTGTATGCAGTTACGA
GTAAACTCCCTATATAAGG -> TAAACTCCCTATATAAGGA
GTAACCCTCGTTTACGTAG -> TAACCCTCGTTTACGTAGG
GTAACGCAGTGCATTTAGG -> TAACGCAGTGCATTTAGGT
GTAACGTTTTAAGGACTCG -> TAACGTTTTAAGGACTCGT
GTAAGAGGGGGTTGCCCAC -> TAAGAGGGGGTTGCCCACT
GTAAGAGTGATCTCACAAT -> TAAGAGTGATCTCACAATT
GTAATAAGGACCATCTTCG -> TAATAAGGACCATCTTCGA
GTAATGCCCATTAAACGCT -> TAATGCCCATTAAACGCTG
GTACAATCATAACTCAGGT -> TACAATCATAACTCAGGTA
GTACAGTGTTACGACGCGA -> TACAGTGTTACGACGCGAC
GTACCTACGTCATACTCCA -> TACCTACGTCATACTCCAG
GTACGGATCTCATGGATCT -> TACGGATCTCATGGATCTC
GTACGTCGATTGCGCGTCC -> TACGTCGATTGCGCGTCCA
GTACGTTGTGGCACTGTTG -> TACGTTGTGGCACTGTTGC
GTACTGCGATTTACACGCT -> TACTGCGATTTACACGCTT
GTAGATTTAGATTGCATTG -> TAGATTTAGATTGCATTGT
GTAGCCGCGCCCACCCATA -> TAGCCGCGCCCACCCATAT
GTAGCTAAAGAGTGCAACC -> TAGCTAAAGAGTGCAACCG
GTAGCTAGATATAATGCCG -> TAGCTAGATATAATGCCGA
GTAGGAGCGGAAGGACAAA -> TAGGAGCGGAAGGACAAAA
GTAGGCCAGCTCTCAAGAC -> TAGGCCAGCTCTCAAGACC
GTAGGCCCGCCCCTCACCT -> TAGGCCCGCCCCTCACCTC
GTAGGCTGTCGCGACTAGT -> TAGGCTGTCGCGACTAGTG
GTAGGTCTTCTAATCTACA -> TAGGTCTTCTAATCTACAG
GTAGGTGGCCTTCTATAGT -> TAGGTGGCCTTCTATAGTT
GTAGTCAATTGTATCCCTC -> TAGTCAATTGTATCCCTCT
GTATAGCGATGATTATCCA -> TATAGCGATGATTATCCAA
GTATCCCTCTGTGGCACTT -> TATCCCTCTGTGGCACTTG
GTATCGTTGGTAGCTAGAT -> TATCGTTGGTAGCTAGATA
GTATCTCGATCCGCGTATA -> TATCTCGATCCGCGTATAG
GTATGCAGTTACGACTGAT -> TATGCAGTTACGACTGATA
GTATTCATACGGGCGGGAC -> TATTCATACGGGCGGGACC
GTATTTTTCTACAATAATA -> TATTTTTCTACAATAATAT
GTCAATTGTATCCCTCTGT -> TCAATTGTATCCCTCTGTG
GTCACTTCCAGCCGTAGCT -> TCACTTCCAGCCGTAGCTA
GTCATACTCCAGATTACGT -> TCATACTCCAGATTACGTC
GTCATGTGGTCCGTGTTGT -> TCATGTGGTCCGTGTTGTT
GTCATTCGAATACTCAGCC -> TCATTCGAATACTCAGCCC
GTCATTTGTCACTTCCAGC -> TCATTTGTCACTTCCAGCC
GTCCAAGCACGGACGCGTA -> TCCAAGCACGGACGCGTAA
GTCCACAACATAACGTACG -> TCCACAACATAACGTACGG
GTCCACATGCAGCCTTACT -> TCCACATGCAGCCTTACTG
GTCCAGCTTGTGCGTACAA -> TCCAGCTTGTGCGTACAAT
GTCCAGGAAGTAAGAGGGG -> TCCAGGAAGTAAGAGGGGG
GTCCATAGATCTACAATAA -> TCCATAGATCTACAATAAT
GTCCGATCGAAGGGTCCAA -> TCCGATCGAAGGGTCCAAG
GTCCGTGTTGTTCGTAGCC -> TCCGTGTTGTTCGTAGCCG
GTCCTCTTTGTGCCCAGAG -> TCCTCTTTGTGCCCAGAGT
GTCGATGACAATATGTTAT -> TCGATGACAATATGTTATA
GTCGATTGCGCGTCCAGCT -> TCGATTGCGCGTCCAGCTT
GTCGATTTCCTTGCTCTAC -> TCGATTTCCTTGCTCTACA
GTCGCAGGGGGGTACGTTG -> TCGCAGGGGGGTACGTTGT
GTCGCCGGGGTTTTGTATG -> TCGCCGGGGTTTTGTATGC
GTCGCGACTAGTGATTAGG -> TCGCGACTAGTGATTAGGT
GTCGCTCAAGTTAATTCGC -> TCGCTCAAGTTAATTCGCC
GTCGCTTAGAACTGCTTTA -> TCGCTTAGAACTGCTTTAC
GTCGGAGGTGCGTGTTTAC -> TCGGAGGTGCGTGTTTACG
GTCGGGGTTGCCGACAGTG -> TCGGGGTTGCCGACAGTGG
GTCGTAACGTTTTAAGGAC -> TCGTAACGTTTTAAGGACT
GTCGTACAGTGTTACGACG -> TCGTACAGTGTTACGACGC
GTCGTCGGAGGTGCGTGTT -> TCGTCGGAGGTGCGTGTTT
GTCTACAATAATATGAGGC -> TCTACAATAATATGAGGCA
GTCTATCCAACAGCGGCGT -> TCTATCCAACAGCGGCGTT
GTCTGCCCACATAAATTGG -> TCTGCCCACATAAATTGGG
GTCTGGATTGAGCGGTAGG -> TCTGGATTGAGCGGTAGGA
GTCTTAAACCAGGGGTGTA -> TCTTAAACCAGGGGTGTAA
GTCTTACGATGGAGTTCCT -> TCTTACGATGGAGTTCCTG
GTCTTCTAATCTACAGAAT -> TCTTCTAATCTACAGAATT
GTGAACTTAAGAAATAGAA -> TGAACTTAAGAAATAGAAC
GTGACAGTGAACTTAAGAA -> TGACAGTGAACTTAAGAAA
GTGAGACTCTACAATAATA -> TGAGACTCTACAATAATAT
GTGATATACTTTATTGCCC -> TGATATACTTTATTGCCCA
GTGATCTCACAATTTAAAG -> TGATCTCACAATTTAAAGA
GTGATCTTTTTGCGTCGCT -> TGATCTTTTTGCGTCGCTT
GTGATTAGGTGTTTCGTTT -> TGATTAGGTGTTTCGTTTA
GTGCAACCGGGTCCAGGAA -> TGCAACCGGGTCCAGGAAG
GTGCATTTAGGTAGATTTA -> TGCATTTAGGTAGATTTAG
GTGCCCAGAGTGACAGTGA -> TGCCCAGAGTGACAGTGAA
GTGCGTACAATCATAACTC -> TGCGTACAATCATAACTCA
GTGCGTGTTTACGAAGCGA -> TGCGTGTTTACGAAGCGAA
GTGCTAAAGGACTCAGACA -> TGCTAAAGGACTCAGACAT
GTGGCACTGTTGCCAATAC -> TGGCACTGTTGCCAATACA
GTGGCACTTGTTGCGCATT -> TGGCACTTGTTGCGCATTT
GTGGCCTTCTATAGTTGCT -> TGGCCTTCTATAGTTGCTC
GTGGGAATGTACCTACGTC -> TGGGAATGTACCTACGTCA
GTGGTCATTTGTCACTTCC -> TGGTCATTTGTCACTTCCA
GTGGTCCGTGTTGTTCGTA -> TGGTCCGTGTTGTTCGTAG
GTGTAATGCCCATTAAACG -> TGTAATGCCCATTAAACGC
GTGTATCTCGATCCGCGTA -> TGTATCTCGATCCGCGTAT
GTGTCGATTTCCTTGCTCT -> TGTCGATTTCCTTGCTCTA
GTGTCGCCGGGGTTTTGTA -> TGTCGCCGGGGTTTTGTAT
GTGTTACGACGCGACCTTC -> TGTTACGACGCGACCTTCT
GTGTTCAAAGTTTTTTGCT -> TGTTCAAAGTTTTTTGCTC
GTGTTCGAGTTGACCAGAT -> TGTTCGAGTTGACCAGATA
GTGTTGCCGACTGGGCGTC -> TGTTGCCGACTGGGCGTCG
GTGTTGTTCGTAGCCGCGC -> TGTTGTTCGTAGCCGCGCC
GTGTTTACGAAGCGAATTC -> TGTTTACGAAGCGAATTCC
GTGTTTCGTTTAAAGCTCG -> TGTTTCGTTTAAAGCTCGC
GTTAAACCGATCTGTATCG -> TTAAACCGATCTGTATCGT
GTTAATTCGCCTCCGCCTT -> TTAATTCGCCTCCGCCTTT
GTTACGACGCGACCTTCTC -> TTACGACGCGACCTTCTCC
GTTACGACTGATATCAGAT -> TTACGACTGATATCAGATT
GTTATACGGATTCTCGAGG -> TTATACGGATTCTCGAGGT
GTTCAAAGTTTTTTGCTCC -> TTCAAAGTTTTTTGCTCCT
GTTCCTGTCCACATGCAGC -> TTCCTGTCCACATGCAGCC
GTTCGAGTTGACCAGATAG -> TTCGAGTTGACCAGATAGA
GTTCGATACGAATGCTAAA -> TTCGATACGAATGCTAAAG
GTTCGCGAAGCCGGCCAGT -> TTCGCGAAGCCGGCCAGTT
GTTCGCTCTGATAGCCATC -> TTCGCTCTGATAGCCATCT
GTTCGTAGCCGCGCCCACC -> TTCGTAGCCGCGCCCACCC
GTTCTGCCGACGCATCCGC -> TTCTGCCGACGCATCCGCC
GTTGACCAGATAGACCACG -> TTGACCAGATAGACCACGA
GTTGACTTCGCAAAGATTT -> TTGACTTCGCAAAGATTTT
GTTGAGAATAGTTTAGTAG -> TTGAGAATAGTTTAGTAGG
GTTGAGAGATAGTGGTCAT -> TTGAGAGATAGTGGTCATT
GTTGCATGCCTCAACGGTA -> TTGCATGCCTCAACGGTAC
GTTGCCAATACAGAAGCCC -> TTGCCAATACAGAAGCCCT
GTTGCCCACTTGAGATAAC -> TTGCCCACTTGAGATAACT
GTTGCCGACAGTGGGAATG -> TTGCCGACAGTGGGAATGT
GTTGCCGACTGGGCGTCGG -> TTGCCGACTGGGCGTCGGG
GTTGCGCATTTAGACGACA -> TTGCGCATTTAGACGACAC
GTTGCTCTCTGGGCTCTGG -> TTGCTCTCTGGGCTCTGGC
GTTGGTAGCTAGATATAAT -> TTGGTAGCTAGATATAATG
GTTGTGGCACTGTTGCCAA -> TTGTGGCACTGTTGCCAAT
GTTGTTCGTAGCCGCGCCC -> TTGTTCGTAGCCGCGCCCA
GTTGTTGAGAATAGTTTAG -> TTGTTGAGAATAGTTTAGT
GTTTAAAGCTCGCCGAGTC -> TTTAAAGCTCGCCGAGTCC
GTTTAATCACAAAATCCAA -> TTTAATCACAAAATCCAAA
GTTTACGAAGCGAATTCCT -> TTTACGAAGCGAATTCCTT
GTTTACGTAGGCTGTCGCG -> TTTACGTAGGCTGTCGCGA
GTTTAGTAGGTCTTCTAAT -> TTTAGTAGGTCTTCTAATC
GTTTCCGCGGAGTAAACTC -> TTTCCGCGGAGTAAACTCC
GTTTCGTTTAAAGCTCGCC -> TTTCGTTTAAAGCTCGCCG
GTTTGCCGGAGATCTTCGC -> TTTGCCGGAGATCTTCGCT
GTTTTAAGGACTCGTCTTA -> TTTTAAGGACTCGTCTTAC
GTTTTGTATGCAGTTACGA -> TTTTGTATGCAGTTACGAC
GTTTTTTGCTCCTCGGCCA -> TTTTTTGCTCCTCGGCCAA
TAAAAAGTATTTTTCTACA -> AAAAAGTATTTTTCTACAA
TAAACACTCCATATGCCAG -> AAACACTCCATATGCCAGC
TAAACCAGGGGTGTAATGC -> AAACCAGGGGTGTAATGCC
TAAACCGATCTGTATCGTT -> AAACCGATCTGTATCGTTG
TAAACGCTGGTAGGTGGCC -> AAACGCTGGTAGGTGGCCT
TAAACTCCCTATATAAGGA -> AAACTCCCTATATAAGGAG
TAAAGAAACGGTTGACTTC -> AAAGAAACGGTTGACTTCG
TAAAGACCATTTACTTGCC -> AAAGACCATTTACTTGCCT
TAAAGAGTGCAACCGGGTC -> AAAGAGTGCAACCGGGTCC
TAAAGCTCGCCGAGTCCGA -> AAAGCTCGCCGAGTCCGAT
TAAAGGACTCAGACATGCA -> AAAGGACTCAGACATGCAC
TAAAGGATCAACGTCTGGA -> AAAGGATCAACGTCTGGAT
TAAATTGGGTCGATGACAA -> AAATTGGGTCGATGACAAT
TAACAATCACTAGGTTTGC -> AACAATCACTAGGTTTGCC
TAACAGGGAGACCTAGAAT -> AACAGGGAGACCTAGAATT
TAACCCTCGTTTACGTAGG -> AACCCTCGTTTACGTAGGC
TAACCCTGGAATTCTTTCG -> AACCCTGGAATTCTTTCGT
TAACGCAGTGCATTTAGGT -> AACGCAGTGCATTTAGGTA
TAACGCATAACAGGGAGAC -> AACGCATAACAGGGAGACC
TAACGTACGGATCTCATGG -> AACGTACGGATCTCATGGA
TAACGTTTTAAGGACTCGT -> AACGTTTTAAGGACTCGTC
TAACTCAGGTAACGCAGTG -> AACTCAGGTAACGCAGTGC
TAACTGATAAGCCGCCAGC -> AACTGATAAGCCGCCAGCG
TAAGACTACGGCGCTAATC -> AAGACTACGGCGCTAATCA
TAAGAGGGGGTTGCCCACT -> AAGAGGGGGTTGCCCACTT
TAAGAGTGATCTCACAATT -> AAGAGTGATCTCACAATTT
TAAGCCGCCAGCGAGCTAT -> AAGCCGCCAGCGAGCTATG
TAAGGACCATCTTCGATTG -> AAGGACCATCTTCGATTGA
TAAGGACTCGTCTTACGAT -> AAGGACTCGTCTTACGATG
TAAGGAGGGGGGTCCTCTT -> AAGGAGGGGGGTCCTCTTT
TAAGGGCGAATAGTCGTCG -> AAGGGCGAATAGTCGTCGG
TAATAAGGACCATCTTCGA -> AATAAGGACCATCTTCGAT
TAATATGAGGCACAAGCTC -> AATATGAGGCACAAGCTCT
TAATATGAGGCACTAACGC -> AATATGAGGCACTAACGCA
TAATATGAGGCACTGTCAT -> AATATGAGGCACTGTCATT
TAATATGAGGCAGCTGAAT -> AATATGAGGCAGCTGAATA
TAATCACAAAATCCAAAAA -> AATCACAAAATCCAAAAAT
TAATCATTAGAACTTGCAT -> AATCATTAGAACTTGCATA
TAATCTACAGAATTGACTT -> AATCTACAGAATTGACTTG
TAATGCCCATTAAACGCTG -> AATGCCCATTAAACGCTGG
TAATGCCGACCTAGCTGAA -> AATGCCGACCTAGCTGAAC
TAATTCGCCTCCGCCTTTC -> AATTCGCCTCCGCCTTTCG
TACAACTACTTCTGTTCGC -> ACAACTACTTCTGTTCGCG
TACAAGTGTCGCCGGGGTT -> ACAAGTGTCGCCGGGGTTT
TACAATAATATGAGGCACA -> ACAATAATATGAGGCACAA
TACAATAATATGAGGCACT -> ACAATAATATGAGGCACTA,ACAATAATATGAGGCACTG
TACAATAATATGAGGCAGC -> ACAATAATATGAGGCAGCT
TACAATCATAACTCAGGTA -> ACAATCATAACTCAGGTAA
TACACGCTTTGGTTTCCGC -> ACACGCTTTGGTTTCCGCG
TACAGAAGCCCTGGGAAGA -> ACAGAAGCCCTGGGAAGAT
TACAGAATTGACTTGCATG -> ACAGAATTGACTTGCATGT
TACAGGGATCTCAGCTGAA -> ACAGGGATCTCAGCTGAAT
TACAGTGTTACGACGCGAC -> ACAGTGTTACGACGCGACC
TACATAGAACATATATGTG -> ACATAGAACATATATGTGT
TACCTACGTCATACTCCAG -> ACCTACGTCATACTCCAGA
TACGAAGCGAATTCCTTTA -> ACGAAGCGAATTCCTTTAT
TACGAATGCTAAAGACCAT -> ACGAATGCTAAAGACCATT
TACGACGCGACCTTCTCCC -> ACGACGCGACCTTCTCCCC
TACGACTGATATCAGATTG -> ACGACTGATATCAGATTGA
TACGATGGAGTTCCTGTCC -> ACGATGGAGTTCCTGTCCA
TACGATGTTCTGCCGACGC -> ACGATGTTCTGCCGACGCA
TACGGATCTCATGGATCTC -> ACGGATCTCATGGATCTCA
TACGGATTCTCGAGGTAGT -> ACGGATTCTCGAGGTAGTC
TACGGCGCTAATCATTAGA -> ACGGCGCTAATCATTAGAA
TACGGGCGGGACCCGCTCG -> ACGGGCGGGACCCGCTCGC
TACGTAGGCTGTCGCGACT -> ACGTAGGCTGTCGCGACTA
TACGTCATACTCCAGATTA -> ACGTCATACTCCAGATTAC
TACGTCGATTGCGCGTCCA -> ACGTCGATTGCGCGTCCAG
TACGTCGCTCAAGTTAATT -> ACGTCGCTCAAGTTAATTC
TACGTTGTGGCACTGTTGC -> ACGTTGTGGCACTGTTGCC
TACTCAGCCCAAAGGATCT -> ACTCAGCCCAAAGGATCTC
TACTCCACAGAGGTCTACA -> ACTCCACAGAGGTCTACAA
TACTCCAGATTACGTCGCT -> ACTCCAGATTACGTCGCTC
TACTGCGATTTACACGCTT -> ACTGCGATTTACACGCTTT
TACTGGATGGGTAGGCCCG -> ACTGGATGGGTAGGCCCGC
TACTGTTCGATACGAATGC -> ACTGTTCGATACGAATGCT
TACTTCTGTTCGCGAAGCC -> ACTTCTGTTCGCGAAGCCG
TACTTGCCTACATAGAACA -> ACTTGCCTACATAGAACAT
TACTTTATTGCCCAGCCCA -> ACTTTATTGCCCAGCCCAC
TAGAACATATATGTGTTCA -> AGAACATATATGTGTTCAA
TAGAACTGCTTTACTGTTC -> AGAACTGCTTTACTGTTCG
TAGAACTTGCATAGCTGTT -> AGAACTTGCATAGCTGTTG
TAGAATTTGGGCGGACAGC -> AGAATTTGGGCGGACAGCG
TAGACCACGAACTCATTCC -> AGACCACGAACTCATTCCC
TAGACGACACCCTATACAG -> AGACGACACCCTATACAGG
TAGAGGTCATGTGGTCCGT -> AGAGGTCATGTGGTCCGTG
TAGATATAATGCCGACCTA -> AGATATAATGCCGACCTAG
TAGATCTACAATAATATGA -> AGATCTACAATAATATGAG
TAGATTGCATTGTATTCAT -> AGATTGCATTGTATTCATA
TAGATTTAGATTGCATTGT -> AGATTTAGATTGCATTGTA
TAGCCATCTCTTGTAACCC -> AGCCATCTCTTGTAACCCT
TAGCCGCGCCCACCCATAT -> AGCCGCGCCCACCCATATT
TAGCGATGATTATCCAATT -> AGCGATGATTATCCAATTC
TAGCGTACGTCGATTGCGC -> AGCGTACGTCGATTGCGCG
TAGCTAAAGAGTGCAACCG -> AGCTAAAGAGTGCAACCGG
TAGCTAGATATAATGCCGA -> AGCTAGATATAATGCCGAC
TAGCTAGTGAGACTCTACA -> AGCTAGTGAGACTCTACAA
TAGCTGAACAGCTAACAAT -> AGCTGAACAGCTAACAATC
TAGCTGTTGAGAGATAGTG -> AGCTGTTGAGAGATAGTGG
TAGGAGCGGAAGGACAAAA -> AGGAGCGGAAGGACAAAAC
TAGGCCAGCTCTCAAGACC -> AGGCCAGCTCTCAAGACCA
TAGGCCCGCCCCTCACCTC -> AGGCCCGCCCCTCACCTCA
TAGGCTGTCGCGACTAGTG -> AGGCTGTCGCGACTAGTGA
TAGGGTGCTAAAGGACTCA -> AGGGTGCTAAAGGACTCAG
TAGGTAGATTTAGATTGCA -> AGGTAGATTTAGATTGCAT
TAGGTCTTCTAATCTACAG -> AGGTCTTCTAATCTACAGA
TAGGTGGCCTTCTATAGTT -> AGGTGGCCTTCTATAGTTG
TAGGTGTTGCCGACTGGGC -> AGGTGTTGCCGACTGGGCG
TAGGTGTTTCGTTTAAAGC -> AGGTGTTTCGTTTAAAGCT
TAGGTTTGCCGGAGATCTT -> AGGTTTGCCGGAGATCTTC
TAGTAGGTCTTCTAATCTA -> AGTAGGTCTTCTAATCTAC
TAGTCAATTGTATCCCTCT -> AGTCAATTGTATCCCTCTG
TAGTCCATAGATCTACAAT -> AGTCCATAGATCTACAATA
TAGTCGTACAGTGTTACGA -> AGTCGTACAGTGTTACGAC
TAGTCGTCGGAGGTGCGTG -> AGTCGTCGGAGGTGCGTGT
TAGTGAGACTCTACAATAA -> AGTGAGACTCTACAATAAT
TAGTGATTAGGTGTTTCGT -> AGTGATTAGGTGTTTCGTT
TAGTGGTCATTTGTCACTT -> AGTGGTCATTTGTCACTTC
TAGTTGCTCTCTGGGCTCT -> AGTTGCTCTCTGGGCTCTG
TAGTTTAGTAGGTCTTCTA -> AGTTTAGTAGGTCTTCTAA
TATAAAAAGTATTTTTCTA -> ATAAAAAGTATTTTTCTAC
TATAACCCTGGAATTCTTT -> ATAACCCTGGAATTCTTTC
TATAAGGAGGGGGGTCCTC -> ATAAGGAGGGGGGTCCTCT
TATAATGCCGACCTAGCTG -> ATAATGCCGACCTAGCTGA
TATACAGGGATCTCAGCTG -> ATACAGGGATCTCAGCTGA
TATACGGATTCTCGAGGTA -> ATACGGATTCTCGAGGTAG
TATACTCCACAGAGGTCTA -> ATACTCCACAGAGGTCTAC
TATACTTTATTGCCCAGCC -> ATACTTTATTGCCCAGCCC
TATAGCGATGATTATCCAA -> ATAGCGATGATTATCCAAT
TATAGCTAGTGAGACTCTA -> ATAGCTAGTGAGACTCTAC
TATAGTCCATAGATCTACA -> ATAGTCCATAGATCTACAA
TATAGTTGCTCTCTGGGCT -> ATAGTTGCTCTCTGGGCTC
TATATAAGGAGGGGGGTCC -> ATATAAGGAGGGGGGTCCT
TATATAGTCCATAGATCTA -> ATATAGTCCATAGATCTAC
TATATGTGTTCAAAGTTTT -> ATATGTGTTCAAAGTTTTT
TATCAGATTGAGCAGTCCA -> ATCAGATTGAGCAGTCCAC
TATCCAACAGCGGCGTTAA -> ATCCAACAGCGGCGTTAAA
TATCCAATTCCACTTAAGG -> ATCCAATTCCACTTAAGGG
TATCCCTCTGTGGCACTTG -> ATCCCTCTGTGGCACTTGT
TATCGTTGGTAGCTAGATA -> ATCGTTGGTAGCTAGATAT
TATCTAAACACTCCATATG -> ATCTAAACACTCCATATGC
TATCTCGATCCGCGTATAG -> ATCTCGATCCGCGTATAGC
TATGAGGCACAAGCTCTAA -> ATGAGGCACAAGCTCTAAA
TATGAGGCACTAACGCATA -> ATGAGGCACTAACGCATAA
TATGAGGCACTGTCATTCG -> ATGAGGCACTGTCATTCGA
TATGAGGCAGCTGAATATA -> ATGAGGCAGCTGAATATAC
TATGCAGTTACGACTGATA -> ATGCAGTTACGACTGATAT
TATGCCAGCCTCGTAGGCC -> ATGCCAGCCTCGTAGGCCA
TATGGGGAGAACTTCGTCG -> ATGGGGAGAACTTCGTCGT
TATGTGTTCAAAGTTTTTT -> ATGTGTTCAAAGTTTTTTG
TATGTTATACGGATTCTCG -> ATGTTATACGGATTCTCGA
TATTAGGGTGCTAAAGGAC -> ATTAGGGTGCTAAAGGACT
TATTCATACGGGCGGGACC -> ATTCATACGGGCGGGACCC
TATTGCCCAGCCCACTCAT -> ATTGCCCAGCCCACTCATC
TATTTTTCTACAATAATAT -> ATTTTTCTACAATAATATG
TCAAAGTTTTTTGCTCCTC -> CAAAGTTTTTTGCTCCTCG
TCAACCGGTCTGCCCACAT -> CAACCGGTCTGCCCACATA
TCAACGGTACTGCGATTTA -> CAACGGTACTGCGATTTAC
TCAACGTCTGGATTGAGCG -> CAACGTCTGGATTGAGCGG
TCAAGACCATCGAAGTGTC -> CAAGACCATCGAAGTGTCG
TCAAGTTAATTCGCCTCCG -> CAAGTTAATTCGCCTCCGC
TCAATTGTATCCCTCTGTG -> CAATTGTATCCCTCTGTGG
TCACAAAATCCAAAAATAA -> CACAAAATCCAAAAATAAG
TCACAATTTAAAGAAACGG -> CACAATTTAAAGAAACGGT
TCACCTCAACCGGTCTGCC -> CACCTCAACCGGTCTGCCC
TCACTAGGTTTGCCGGAGA -> CACTAGGTTTGCCGGAGAT
TCACTTCCAGCCGTAGCTA -> CACTTCCAGCCGTAGCTAA
TCAGACATGCACCAAGCGT -> CAGACATGCACCAAGCGTC
TCAGATTGAGCAGTCCACA -> CAGATTGAGCAGTCCACAA
TCAGCCCAAAGGATCTCAG -> CAGCCCAAAGGATCTCAGC
TCAGCTGAATATAAAAAGT -> CAGCTGAATATAAAAAGTA
TCAGCTGAATATAGCTAGT -> CAGCTGAATATAGCTAGTG
TCAGCTGAATATATAGTCC -> CAGCTGAATATATAGTCCA
TCAGGTAACGCAGTGCATT -> CAGGTAACGCAGTGCATTT
TCATAACTCAGGTAACGCA -> CATAACTCAGGTAACGCAG
TCATACGGGCGGGACCCGC -> CATACGGGCGGGACCCGCT
TCATACTCCAGATTACGTC -> CATACTCCAGATTACGTCG
TCATCGATTGCCGATAGTC -> CATCGATTGCCGATAGTCG
TCATGGATCTCAGCTGAAT -> CATGGATCTCAGCTGAATA
TCATGTCGCAGGGGGGTAC -> CATGTCGCAGGGGGGTACG
TCATGTGGTCCGTGTTGTT -> CATGTGGTCCGTGTTGTTC
TCATTAGAACTTGCATAGC -> CATTAGAACTTGCATAGCT
TCATTCCCGGGCTTGTTCG -> CATTCCCGGGCTTGTTCGC
TCATTCGAATACTCAGCCC -> CATTCGAATACTCAGCCCA
TCATTTGTCACTTCCAGCC -> CATTTGTCACTTCCAGCCG
TCCAAAAATAAGACTACGG -> CCAAAAATAAGACTACGGC
TCCAACAGCGGCGTTAAAC -> CCAACAGCGGCGTTAAACC
TCCAAGCACGGACGCGTAA -> CCAAGCACGGACGCGTAAT
TCCAATTCCACTTAAGGGC -> CCAATTCCACTTAAGGGCG
TCCACAACATAACGTACGG -> CCACAACATAACGTACGGA
TCCACAGAGGTCTACAATA -> CCACAGAGGTCTACAATAA
TCCACATGCAGCCTTACTG -> CCACATGCAGCCTTACTGG
TCCACTTAAGGGCGAATAG -> CCACTTAAGGGCGAATAGT
TCCAGATTACGTCGCTCAA -> CCAGATTACGTCGCTCAAG
TCCAGCCGTAGCTAAAGAG -> CCAGCCGTAGCTAAAGAGT
TCCAGCTTGTGCGTACAAT -> CCAGCTTGTGCGTACAATC
TCCAGGAAGTAAGAGGGGG -> CCAGGAAGTAAGAGGGGGT
TCCATAGATCTACAATAAT -> CCATAGATCTACAATAATA
TCCATATGCCAGCCTCGTA -> CCATATGCCAGCCTCGTAG
TCCCCCTTGCCTCCCTAGA -> CCCCCTTGCCTCCCTAGAG
TCCCGGGCTTGTTCGCTCT -> CCCGGGCTTGTTCGCTCTG
TCCCTAGAGGTCATGTGGT -> CCCTAGAGGTCATGTGGTC
TCCCTATATAAGGAGGGGG -> CCCTATATAAGGAGGGGGG
TCCCTCTGTGGCACTTGTT -> CCCTCTGTGGCACTTGTTG
TCCGATCGAAGGGTCCAAG -> CCGATCGAAGGGTCCAAGC
TCCGCCTAGGTGTTGCCGA -> CCGCCTAGGTGTTGCCGAC
TCCGCCTTTCGAGAGGAGT -> CCGCCTTTCGAGAGGAGTG
TCCGCGGAGTAAACTCCCT -> CCGCGGAGTAAACTCCCTA
TCCGCGTATAGCGATGATT -> CCGCGTATAGCGATGATTA
TCCGGTGATATACTTTATT -> CCGGTGATATACTTTATTG
TCCGTGTTGTTCGTAGCCG -> CCGTGTTGTTCGTAGCCGC
TCCTCGGCCAATACAAGTG -> CCTCGGCCAATACAAGTGT
TCCTCTTTGTGCCCAGAGT -> CCTCTTTGTGCCCAGAGTG
TCCTGAACGTGTATCTCGA -> CCTGAACGTGTATCTCGAT
TCCTGTCCACATGCAGCCT -> CCTGTCCACATGCAGCCTT
TCCTTGCTCTACAACTACT -> CCTTGCTCTACAACTACTT
TCCTTTATCTAAACACTCC -> CCTTTATCTAAACACTCCA
TCGAAGGGTCCAAGCACGG -> CGAAGGGTCCAAGCACGGA
TCGAAGTGTCGATTTCCTT -> CGAAGTGTCGATTTCCTTG
TCGAATACTCAGCCCAAAG -> CGAATACTCAGCCCAAAGG
TCGAGAGGAGTGTTCGAGT -> CGAGAGGAGTGTTCGAGTT
TCGAGGTAGTCAATTGTAT -> CGAGGTAGTCAATTGTATC
TCGAGTTGACCAGATAGAC -> CGAGTTGACCAGATAGACC
TCGATACGAATGCTAAAGA -> CGATACGAATGCTAAAGAC
TCGATCCGCGTATAGCGAT -> CGATCCGCGTATAGCGATG
TCGATGACAATATGTTATA -> CGATGACAATATGTTATAC
TCGATTGATGAGCCCAGTC -> CGATTGATGAGCCCAGTCT
TCGATTGCCGATAGTCGTA -> CGATTGCCGATAGTCGTAC
TCGATTGCGCGTCCAGCTT -> CGATTGCGCGTCCAGCTTG
TCGATTTCCTTGCTCTACA -> CGATTTCCTTGCTCTACAA
TCGCAAAGATTTTCCGGTG -> CGCAAAGATTTTCCGGTGA
TCGCAGGGGGGTACGTTGT -> CGCAGGGGGGTACGTTGTG
TCGCCGAGTCCGATCGAAG -> CGCCGAGTCCGATCGAAGG
TCGCCGGGGTTTTGTATGC -> CGCCGGGGTTTTGTATGCA
TCGCCTCCGCCTTTCGAGA -> CGCCTCCGCCTTTCGAGAG
TCGCGAAGCCGGCCAGTTT -> CGCGAAGCCGGCCAGTTTA
TCGCGACTAGTGATTAGGT -> CGCGACTAGTGATTAGGTG
TCGCTACGATGTTCTGCCG -> CGCTACGATGTTCTGCCGA
TCGCTCAAGTTAATTCGCC -> CGCTCAAGTTAATTCGCCT
TCGCTCCTGAACGTGTATC -> CGCTCCTGAACGTGTATCT
TCGCTCTGATAGCCATCTC -> CGCTCTGATAGCCATCTCT
TCGCTTAGAACTGCTTTAC -> CGCTTAGAACTGCTTTACT
TCGGAGGTGCGTGTTTACG -> CGGAGGTGCGTGTTTACGA
TCGGCCAATACAAGTGTCG -> CGGCCAATACAAGTGTCGC
TCGGGGTTGCCGACAGTGG -> CGGGGTTGCCGACAGTGGG
TCGTAACGTTTTAAGGACT -> CGTAACGTTTTAAGGACTC
TCGTACAGTGTTACGACGC -> CGTACAGTGTTACGACGCG
TCGTAGCCGCGCCCACCCA -> CGTAGCCGCGCCCACCCAT
TCGTAGGCCAGCTCTCAAG -> CGTAGGCCAGCTCTCAAGA
TCGTCGGAGGTGCGTGTTT -> CGTCGGAGGTGCGTGTTTA
TCGTCGTAACGTTTTAAGG -> CGTCGTAACGTTTTAAGGA
TCGTCTTACGATGGAGTTC -> CGTCTTACGATGGAGTTCC
TCGTTGGTAGCTAGATATA -> CGTTGGTAGCTAGATATAA
TCGTTGTTGAGAATAGTTT -> CGTTGTTGAGAATAGTTTA
TCGTTTAAAGCTCGCCGAG -> CGTTTAAAGCTCGCCGAGT
TCGTTTACGTAGGCTGTCG -> CGTTTACGTAGGCTGTCGC
TCTAAACACTCCATATGCC -> CTAAACACTCCATATGCCA
TCTAAAGGATCAACGTCTG -> CTAAAGGATCAACGTCTGG
TCTAATCTACAGAATTGAC -> CTAATCTACAGAATTGACT
TCTACAACTACTTCTGTTC -> CTACAACTACTTCTGTTCG
TCTACAATAATATGAGGCA -> CTACAATAATATGAGGCAC,CTACAATAATATGAGGCAC,CTACAATAATATGAGGCAC,CTACAATAATATGAGGCAG
TCTACAGAATTGACTTGCA -> CTACAGAATTGACTTGCAT
TCTATAGTTGCTCTCTGGG -> CTATAGTTGCTCTCTGGGC
TCTATCCAACAGCGGCGTT -> CTATCCAACAGCGGCGTTA
TCTCAAGACCATCGAAGTG -> CTCAAGACCATCGAAGTGT
TCTCACAATTTAAAGAAAC -> CTCACAATTTAAAGAAACG
TCTCAGCTGAATATAAAAA -> CTCAGCTGAATATAAAAAG
TCTCAGCTGAATATAGCTA -> CTCAGCTGAATATAGCTAG
TCTCAGCTGAATATATAGT -> CTCAGCTGAATATATAGTC
TCTCATGGATCTCAGCTGA -> CTCATGGATCTCAGCTGAA
TCTCCCCCTTGCCTCCCTA -> CTCCCCCTTGCCTCCCTAG
TCTCGAGGTAGTCAATTGT -> CTCGAGGTAGTCAATTGTA
TCTCGATCCGCGTATAGCG -> CTCGATCCGCGTATAGCGA
TCTCTGGGCTCTGGCACCC -> CTCTGGGCTCTGGCACCCC
TCTCTTGTAACCCTCGTTT -> CTCTTGTAACCCTCGTTTA
TCTGATAGCCATCTCTTGT -> CTGATAGCCATCTCTTGTA
TCTGCCCACATAAATTGGG -> CTGCCCACATAAATTGGGT
TCTGCCGACGCATCCGCCT -> CTGCCGACGCATCCGCCTA
TCTGGATTGAGCGGTAGGA -> CTGGATTGAGCGGTAGGAG
TCTGGCACCCCCCTATAAC -> CTGGCACCCCCCTATAACC
TCTGGGCTCTGGCACCCCC -> CTGGGCTCTGGCACCCCCC
TCTGTATCGTTGGTAGCTA -> CTGTATCGTTGGTAGCTAG
TCTGTGGCACTTGTTGCGC -> CTGTGGCACTTGTTGCGCA
TCTGTTCGCGAAGCCGGCC -> CTGTTCGCGAAGCCGGCCA
TCTTAAACCAGGGGTGTAA -> CTTAAACCAGGGGTGTAAT
TCTTACGATGGAGTTCCTG -> CTTACGATGGAGTTCCTGT
TCTTCGATTGATGAGCCCA -> CTTCGATTGATGAGCCCAG
TCTTCGCTACGATGTTCTG -> CTTCGCTACGATGTTCTGC
TCTTCTAATCTACAGAATT -> CTTCTAATCTACAGAATTG
TCTTGTAACCCTCGTTTAC -> CTTGTAACCCTCGTTTACG
TCTTTCGTTGTTGAGAATA -> CTTTCGTTGTTGAGAATAG
TCTTTGTGCCCAGAGTGAC -> CTTTGTGCCCAGAGTGACA
TCTTTTTGCGTCGCTTAGA -> CTTTTTGCGTCGCTTAGAA
TGAACAGCTAACAATCACT -> GAACAGCTAACAATCACTA
TGAACCACAGATTTTTTTG -> GAACCACAGATTTTTTTGT
TGAACGTGTATCTCGATCC -> GAACGTGTATCTCGATCCG
TGAACTTAAGAAATAGAAC -> GAACTTAAGAAATAGAACC
TGAATATAAAAAGTATTTT -> GAATATAAAAAGTATTTTT
TGAATATACTCCACAGAGG -> GAATATACTCCACAGAGGT
TGAATATAGCTAGTGAGAC -> GAATATAGCTAGTGAGACT
TGAATATATAGTCCATAGA -> GAATATATAGTCCATAGAT
TGACAATATGTTATACGGA -> GACAATATGTTATACGGAT
TGACAGTGAACTTAAGAAA -> GACAGTGAACTTAAGAAAT
TGACCAGATAGACCACGAA -> GACCAGATAGACCACGAAC
TGACTTCGCAAAGATTTTC -> GACTTCGCAAAGATTTTCC
TGACTTGCATGTTGCATGC -> GACTTGCATGTTGCATGCC
TGAGAATAGTTTAGTAGGT -> GAGAATAGTTTAGTAGGTC
TGAGACTCTACAATAATAT -> GAGACTCTACAATAATATG
TGAGAGATAGTGGTCATTT -> GAGAGATAGTGGTCATTTG
TGAGATAACTGATAAGCCG -> GAGATAACTGATAAGCCGC
TGAGCAGTCCACAACATAA -> GAGCAGTCCACAACATAAC
TGAGCCCAGTCTTAAACCA -> GAGCCCAGTCTTAAACCAG
TGAGCGGTAGGAGCGGAAG -> GAGCGGTAGGAGCGGAAGG
TGAGGCACAAGCTCTAAAG -> GAGGCACAAGCTCTAAAGG
TGAGGCACTAACGCATAAC -> GAGGCACTAACGCATAACA
TGAGGCACTGTCATTCGAA -> GAGGCACTGTCATTCGAAT
TGAGGCAGCTGAATATACT -> GAGGCAGCTGAATATACTC
TGATAAGCCGCCAGCGAGC -> GATAAGCCGCCAGCGAGCT
TGATAGCCATCTCTTGTAA -> GATAGCCATCTCTTGTAAC
TGATATACTTTATTGCCCA -> GATATACTTTATTGCCCAG
TGATATCAGATTGAGCAGT -> GATATCAGATTGAGCAGTC
TGATCTCACAATTTAAAGA -> GATCTCACAATTTAAAGAA
TGATCTTTTTGCGTCGCTT -> GATCTTTTTGCGTCGCTTA
TGATGAGCCCAGTCTTAAA -> GATGAGCCCAGTCTTAAAC
TGATTAGGTGTTTCGTTTA -> GATTAGGTGTTTCGTTTAA
TGATTATCCAATTCCACTT -> GATTATCCAATTCCACTTA
TGCAACCGGGTCCAGGAAG -> GCAACCGGGTCCAGGAAGT
TGCACCAAGCGTCTATCCA -> GCACCAAGCGTCTATCCAA
TGCAGCCTTACTGGATGGG -> GCAGCCTTACTGGATGGGT
TGCAGTTACGACTGATATC -> GCAGTTACGACTGATATCA
TGCATAGCTGTTGAGAGAT -> GCATAGCTGTTGAGAGATA
TGCATGCCTCAACGGTACT -> GCATGCCTCAACGGTACTG
TGCATGTTGCATGCCTCAA -> GCATGTTGCATGCCTCAAC
TGCATTGTATTCATACGGG -> GCATTGTATTCATACGGGC
TGCATTTAGGTAGATTTAG -> GCATTTAGGTAGATTTAGA
TGCCAATACAGAAGCCCTG -> GCCAATACAGAAGCCCTGG
TGCCAGCCTCGTAGGCCAG -> GCCAGCCTCGTAGGCCAGC
TGCCCACATAAATTGGGTC -> GCCCACATAAATTGGGTCG
TGCCCACTTGAGATAACTG -> GCCCACTTGAGATAACTGA
TGCCCAGAGTGACAGTGAA -> GCCCAGAGTGACAGTGAAC
TGCCCAGCCCACTCATCGA -> GCCCAGCCCACTCATCGAT
TGCCCATTAAACGCTGGTA -> GCCCATTAAACGCTGGTAG
TGCCGACAGTGGGAATGTA -> GCCGACAGTGGGAATGTAC
TGCCGACCTAGCTGAACAG -> GCCGACCTAGCTGAACAGC
TGCCGACGCATCCGCCTAG -> GCCGACGCATCCGCCTAGG
TGCCGACTGGGCGTCGGGG -> GCCGACTGGGCGTCGGGGT
TGCCGATAGTCGTACAGTG -> GCCGATAGTCGTACAGTGT
TGCCGGAGATCTTCGCTAC -> GCCGGAGATCTTCGCTACG
TGCCTACATAGAACATATA -> GCCTACATAGAACATATAT
TGCCTCAACGGTACTGCGA -> GCCTCAACGGTACTGCGAT
TGCCTCCCTAGAGGTCATG -> GCCTCCCTAGAGGTCATGT
TGCGATTTACACGCTTTGG -> GCGATTTACACGCTTTGGT
TGCGCATTTAGACGACACC -> GCGCATTTAGACGACACCC
TGCGCGTCCAGCTTGTGCG -> GCGCGTCCAGCTTGTGCGT
TGCGTACAATCATAACTCA -> GCGTACAATCATAACTCAG
TGCGTCGCTTAGAACTGCT -> GCGTCGCTTAGAACTGCTT
TGCGTGTTTACGAAGCGAA -> GCGTGTTTACGAAGCGAAT
TGCTAAAGACCATTTACTT -> GCTAAAGACCATTTACTTG
TGCTAAAGGACTCAGACAT -> GCTAAAGGACTCAGACATG
TGCTCCTCGGCCAATACAA -> GCTCCTCGGCCAATACAAG
TGCTCTACAACTACTTCTG -> GCTCTACAACTACTTCTGT
TGCTCTCTGGGCTCTGGCA -> GCTCTCTGGGCTCTGGCAC
TGCTTTACTGTTCGATACG -> GCTTTACTGTTCGATACGA
TGGAATTCTTTCGTTGTTG -> GGAATTCTTTCGTTGTTGA
TGGAGTTCCTGTCCACATG -> GGAGTTCCTGTCCACATGC
TGGATCTCAGCTGAATATA -> GGATCTCAGCTGAATATAT
TGGATGGGTAGGCCCGCCC -> GGATGGGTAGGCCCGCCCC
TGGATTGAGCGGTAGGAGC -> GGATTGAGCGGTAGGAGCG
TGGCACCCCCCTATAACCC -> GGCACCCCCCTATAACCCT
TGGCACTGTTGCCAATACA -> GGCACTGTTGCCAATACAG
TGGCACTTGTTGCGCATTT -> GGCACTTGTTGCGCATTTA
TGGCCTTCTATAGTTGCTC -> GGCCTTCTATAGTTGCTCT
TGGGAAGATGAACCACAGA -> GGGAAGATGAACCACAGAT
TGGGAATGTACCTACGTCA -> GGGAATGTACCTACGTCAT
TGGGCGGACAGCGGCCGTG -> GGGCGGACAGCGGCCGTGA
TGGGCGTCGGGGTTGCCGA -> GGGCGTCGGGGTTGCCGAC
TGGGCTCTGGCACCCCCCT -> GGGCTCTGGCACCCCCCTA
TGGGGAGAACTTCGTCGTA -> GGGGAGAACTTCGTCGTAA
TGGGTAGGCCCGCCCCTCA -> GGGTAGGCCCGCCCCTCAC
TGGGTCGATGACAATATGT -> GGGTCGATGACAATATGTT
TGGTAGCTAGATATAATGC -> GGTAGCTAGATATAATGCC
TGGTAGGTGGCCTTCTATA -> GGTAGGTGGCCTTCTATAG
TGGTCATTTGTCACTTCCA -> GGTCATTTGTCACTTCCAG
TGGTCCGTGTTGTTCGTAG -> GGTCCGTGTTGTTCGTAGC
TGGTTTCCGCGGAGTAAAC -> GGTTTCCGCGGAGTAAACT
TGTAACCCTCGTTTACGTA -> GTAACCCTCGTTTACGTAG
TGTAAGAGTGATCTCACAA -> GTAAGAGTGATCTCACAAT
TGTAATGCCCATTAAACGC -> GTAATGCCCATTAAACGCT
TGTACCTACGTCATACTCC -> GTACCTACGTCATACTCCA
TGTATCCCTCTGTGGCACT -> GTATCCCTCTGTGGCACTT
TGTATCGTTGGTAGCTAGA -> GTATCGTTGGTAGCTAGAT
TGTATCTCGATCCGCGTAT -> GTATCTCGATCCGCGTATA
TGTATGCAGTTACGACTGA -> GTATGCAGTTACGACTGAT
TGTATTCATACGGGCGGGA -> GTATTCATACGGGCGGGAC
TGTCACTTCCAGCCGTAGC -> GTCACTTCCAGCCGTAGCT
TGTCATTCGAATACTCAGC -> GTCATTCGAATACTCAGCC
TGTCCACATGCAGCCTTAC -> GTCCACATGCAGCCTTACT
TGTCGATTTCCTTGCTCTA -> GTCGATTTCCTTGCTCTAC
TGTCGCAGGGGGGTACGTT -> GTCGCAGGGGGGTACGTTG
TGTCGCCGGGGTTTTGTAT -> GTCGCCGGGGTTTTGTATG
TGTCGCGACTAGTGATTAG -> GTCGCGACTAGTGATTAGG
TGTGCCCAGAGTGACAGTG -> GTGCCCAGAGTGACAGTGA
TGTGCGTACAATCATAACT -> GTGCGTACAATCATAACTC
TGTGGCACTGTTGCCAATA -> GTGGCACTGTTGCCAATAC
TGTGGCACTTGTTGCGCAT -> GTGGCACTTGTTGCGCATT
TGTGGTCCGTGTTGTTCGT -> GTGGTCCGTGTTGTTCGTA
TGTGTTCAAAGTTTTTTGC -> GTGTTCAAAGTTTTTTGCT
TGTTACGACGCGACCTTCT -> GTTACGACGCGACCTTCTC
TGTTATACGGATTCTCGAG -> GTTATACGGATTCTCGAGG
TGTTCAAAGTTTTTTGCTC -> GTTCAAAGTTTTTTGCTCC
TGTTCGAGTTGACCAGATA -> GTTCGAGTTGACCAGATAG
TGTTCGATACGAATGCTAA -> GTTCGATACGAATGCTAAA
TGTTCGCGAAGCCGGCCAG -> GTTCGCGAAGCCGGCCAGT
TGTTCGCTCTGATAGCCAT -> GTTCGCTCTGATAGCCATC
TGTTCGTAGCCGCGCCCAC -> GTTCGTAGCCGCGCCCACC
TGTTCTGCCGACGCATCCG -> GTTCTGCCGACGCATCCGC
TGTTGAGAATAGTTTAGTA -> GTTGAGAATAGTTTAGTAG
TGTTGAGAGATAGTGGTCA -> GTTGAGAGATAGTGGTCAT
TGTTGCATGCCTCAACGGT -> GTTGCATGCCTCAACGGTA
TGTTGCCAATACAGAAGCC -> GTTGCCAATACAGAAGCCC
TGTTGCCGACTGGGCGTCG -> GTTGCCGACTGGGCGTCGG
TGTTGCGCATTTAGACGAC -> GTTGCGCATTTAGACGACA
TGTTGTTCGTAGCCGCGCC -> GTTGTTCGTAGCCGCGCCC
TGTTTACGAAGCGAATTCC -> GTTTACGAAGCGAATTCCT
TGTTTCGTTTAAAGCTCGC -> GTTTCGTTTAAAGCTCGCC
TTAAACCAGGGGTGTAATG -> TAAACCAGGGGTGTAATGC
TTAAACCGATCTGTATCGT -> TAAACCGATCTGTATCGTT
TTAAACGCTGGTAGGTGGC -> TAAACGCTGGTAGGTGGCC
TTAAAGAAACGGTTGACTT -> TAAAGAAACGGTTGACTTC
TTAAAGCTCGCCGAGTCCG -> TAAAGCTCGCCGAGTCCGA
TTAAGAAATAGAACCTTGC -> TAAGAAATAGAACCTTGCA
TTAAGGACTCGTCTTACGA -> TAAGGACTCGTCTTACGAT
TTAAGGGCGAATAGTCGTC -> TAAGGGCGAATAGTCGTCG
TTAATCACAAAATCCAAAA -> TAATCACAAAATCCAAAAA
TTAATTCGCCTCCGCCTTT -> TAATTCGCCTCCGCCTTTC
TTACACGCTTTGGTTTCCG -> TACACGCTTTGGTTTCCGC
TTACGAAGCGAATTCCTTT -> TACGAAGCGAATTCCTTTA
TTACGACGCGACCTTCTCC -> TACGACGCGACCTTCTCCC
TTACGACTGATATCAGATT -> TACGACTGATATCAGATTG
TTACGATGGAGTTCCTGTC -> TACGATGGAGTTCCTGTCC
TTACGTAGGCTGTCGCGAC -> TACGTAGGCTGTCGCGACT
TTACGTCGCTCAAGTTAAT -> TACGTCGCTCAAGTTAATT
TTACTGGATGGGTAGGCCC -> TACTGGATGGGTAGGCCCG
TTACTGTTCGATACGAATG -> TACTGTTCGATACGAATGC
TTACTTGCCTACATAGAAC -> TACTTGCCTACATAGAACA
TTAGAACTGCTTTACTGTT -> TAGAACTGCTTTACTGTTC
TTAGAACTTGCATAGCTGT -> TAGAACTTGCATAGCTGTT
TTAGACGACACCCTATACA -> TAGACGACACCCTATACAG
TTAGATTGCATTGTATTCA -> TAGATTGCATTGTATTCAT
TTAGGGTGCTAAAGGACTC -> TAGGGTGCTAAAGGACTCA
TTAGGTAGATTTAGATTGC -> TAGGTAGATTTAGATTGCA
TTAGGTGTTTCGTTTAAAG -> TAGGTGTTTCGTTTAAAGC
TTAGTAGGTCTTCTAATCT -> TAGTAGGTCTTCTAATCTA
TTATACGGATTCTCGAGGT -> TATACGGATTCTCGAGGTA
TTATCCAATTCCACTTAAG -> TATCCAATTCCACTTAAGG
TTATCTAAACACTCCATAT -> TATCTAAACACTCCATATG
TTATTGCCCAGCCCACTCA -> TATTGCCCAGCCCACTCAT
TTCAAAGTTTTTTGCTCCT -> TCAAAGTTTTTTGCTCCTC
TTCATACGGGCGGGACCCG -> TCATACGGGCGGGACCCGC
TTCCACTTAAGGGCGAATA -> TCCACTTAAGGGCGAATAG
TTCCAGCCGTAGCTAAAGA -> TCCAGCCGTAGCTAAAGAG
TTCCCGGGCTTGTTCGCTC -> TCCCGGGCTTGTTCGCTCT
TTCCGCGGAGTAAACTCCC -> TCCGCGGAGTAAACTCCCT
TTCCGGTGATATACTTTAT -> TCCGGTGATATACTTTATT
TTCCTGTCCACATGCAGCC -> TCCTGTCCACATGCAGCCT
TTCCTTGCTCTACAACTAC -> TCCTTGCTCTACAACTACT
TTCCTTTATCTAAACACTC -> TCCTTTATCTAAACACTCC
TTCGAATACTCAGCCCAAA -> TCGAATACTCAGCCCAAAG
TTCGAGAGGAGTGTTCGAG -> TCGAGAGGAGTGTTCGAGT
TTCGAGTTGACCAGATAGA -> TCGAGTTGACCAGATAGAC
TTCGATACGAATGCTAAAG -> TCGATACGAATGCTAAAGA
TTCGATTGATGAGCCCAGT -> TCGATTGATGAGCCCAGTC
TTCGCAAAGATTTTCCGGT -> TCGCAAAGATTTTCCGGTG
TTCGCCTCCGCCTTTCGAG -> TCGCCTCCGCCTTTCGAGA
TTCGCGAAGCCGGCCAGTT -> TCGCGAAGCCGGCCAGTTT
TTCGCTACGATGTTCTGCC -> TCGCTACGATGTTCTGCCG
TTCGCTCTGATAGCCATCT -> TCGCTCTGATAGCCATCTC
TTCGTAGCCGCGCCCACCC -> TCGTAGCCGCGCCCACCCA
TTCGTCGTAACGTTTTAAG -> TCGTCGTAACGTTTTAAGG
TTCGTTGTTGAGAATAGTT -> TCGTTGTTGAGAATAGTTT
TTCGTTTAAAGCTCGCCGA -> TCGTTTAAAGCTCGCCGAG
TTCTAATCTACAGAATTGA -> TCTAATCTACAGAATTGAC
TTCTACAATAATATGAGGC -> TCTACAATAATATGAGGCA
TTCTATAGTTGCTCTCTGG -> TCTATAGTTGCTCTCTGGG
TTCTCCCCCTTGCCTCCCT -> TCTCCCCCTTGCCTCCCTA
TTCTCGAGGTAGTCAATTG -> TCTCGAGGTAGTCAATTGT
TTCTGCCGACGCATCCGCC -> TCTGCCGACGCATCCGCCT
TTCTGTTCGCGAAGCCGGC -> TCTGTTCGCGAAGCCGGCC
TTCTTTCGTTGTTGAGAAT -> TCTTTCGTTGTTGAGAATA
TTGACCAGATAGACCACGA -> TGACCAGATAGACCACGAA
TTGACTTCGCAAAGATTTT -> TGACTTCGCAAAGATTTTC
TTGACTTGCATGTTGCATG -> TGACTTGCATGTTGCATGC
TTGAGAATAGTTTAGTAGG -> TGAGAATAGTTTAGTAGGT
TTGAGAGATAGTGGTCATT -> TGAGAGATAGTGGTCATTT
TTGAGATAACTGATAAGCC -> TGAGATAACTGATAAGCCG
TTGAGCAGTCCACAACATA -> TGAGCAGTCCACAACATAA
TTGAGCGGTAGGAGCGGAA -> TGAGCGGTAGGAGCGGAAG
TTGATGAGCCCAGTCTTAA -> TGATGAGCCCAGTCTTAAA
TTGCATAGCTGTTGAGAGA -> TGCATAGCTGTTGAGAGAT
TTGCATGCCTCAACGGTAC -> TGCATGCCTCAACGGTACT
TTGCATGTTGCATGCCTCA -> TGCATGTTGCATGCCTCAA
TTGCATTGTATTCATACGG -> TGCATTGTATTCATACGGG
TTGCCAATACAGAAGCCCT -> TGCCAATACAGAAGCCCTG
TTGCCCACTTGAGATAACT -> TGCCCACTTGAGATAACTG
TTGCCCAGCCCACTCATCG -> TGCCCAGCCCACTCATCGA
TTGCCGACAGTGGGAATGT -> TGCCGACAGTGGGAATGTA
TTGCCGACTGGGCGTCGGG -> TGCCGACTGGGCGTCGGGG
TTGCCGATAGTCGTACAGT -> TGCCGATAGTCGTACAGTG
TTGCCGGAGATCTTCGCTA -> TGCCGGAGATCTTCGCTAC
TTGCCTACATAGAACATAT -> TGCCTACATAGAACATATA
TTGCCTCCCTAGAGGTCAT -> TGCCTCCCTAGAGGTCATG
TTGCGCATTTAGACGACAC -> TGCGCATTTAGACGACACC
TTGCGCGTCCAGCTTGTGC -> TGCGCGTCCAGCTTGTGCG
TTGCGTCGCTTAGAACTGC -> TGCGTCGCTTAGAACTGCT
TTGCTCCTCGGCCAATACA -> TGCTCCTCGGCCAATACAA
TTGCTCTACAACTACTTCT -> TGCTCTACAACTACTTCTG
TTGCTCTCTGGGCTCTGGC -> TGCTCTCTGGGCTCTGGCA
TTGGGCGGACAGCGGCCGT -> TGGGCGGACAGCGGCCGTG
TTGGGTCGATGACAATATG -> TGGGTCGATGACAATATGT
TTGGTAGCTAGATATAATG -> TGGTAGCTAGATATAATGC
TTGGTTTCCGCGGAGTAAA -> TGGTTTCCGCGGAGTAAAC
TTGTAACCCTCGTTTACGT -> TGTAACCCTCGTTTACGTA
TTGTAAGAGTGATCTCACA -> TGTAAGAGTGATCTCACAA
TTGTATCCCTCTGTGGCAC -> TGTATCCCTCTGTGGCACT
TTGTATGCAGTTACGACTG -> TGTATGCAGTTACGACTGA
TTGTATTCATACGGGCGGG -> TGTATTCATACGGGCGGGA
TTGTCACTTCCAGCCGTAG -> TGTCACTTCCAGCCGTAGC
TTGTGCCCAGAGTGACAGT -> TGTGCCCAGAGTGACAGTG
TTGTGCGTACAATCATAAC -> TGTGCGTACAATCATAACT
TTGTGGCACTGTTGCCAAT -> TGTGGCACTGTTGCCAATA
TTGTTCGCTCTGATAGCCA -> TGTTCGCTCTGATAGCCAT
TTGTTCGTAGCCGCGCCCA -> TGTTCGTAGCCGCGCCCAC
TTGTTGAGAATAGTTTAGT -> TGTTGAGAATAGTTTAGTA
TTGTTGCGCATTTAGACGA -> TGTTGCGCATTTAGACGAC
TTTAAAGAAACGGTTGACT -> TTAAAGAAACGGTTGACTT
TTTAAAGCTCGCCGAGTCC -> TTAAAGCTCGCCGAGTCCG
TTTAAGGACTCGTCTTACG -> TTAAGGACTCGTCTTACGA
TTTAATCACAAAATCCAAA -> TTAATCACAAAATCCAAAA
TTTACACGCTTTGGTTTCC -> TTACACGCTTTGGTTTCCG
TTTACGAAGCGAATTCCTT -> TTACGAAGCGAATTCCTTT
TTTACGTAGGCTGTCGCGA -> TTACGTAGGCTGTCGCGAC
TTTACTGTTCGATACGAAT -> TTACTGTTCGATACGAATG
TTTACTTGCCTACATAGAA -> TTACTTGCCTACATAGAAC
TTTAGACGACACCCTATAC -> TTAGACGACACCCTATACA
TTTAGATTGCATTGTATTC -> TTAGATTGCATTGTATTCA
TTTAGGTAGATTTAGATTG -> TTAGGTAGATTTAGATTGC
TTTAGTAGGTCTTCTAATC -> TTAGTAGGTCTTCTAATCT
TTTATCTAAACACTCCATA -> TTATCTAAACACTCCATAT
TTTATTGCCCAGCCCACTC -> TTATTGCCCAGCCCACTCA
TTTCCGCGGAGTAAACTCC -> TTCCGCGGAGTAAACTCCC
TTTCCGGTGATATACTTTA -> TTCCGGTGATATACTTTAT
TTTCCTTGCTCTACAACTA -> TTCCTTGCTCTACAACTAC
TTTCGAGAGGAGTGTTCGA -> TTCGAGAGGAGTGTTCGAG
TTTCGTTGTTGAGAATAGT -> TTCGTTGTTGAGAATAGTT
TTTCGTTTAAAGCTCGCCG -> TTCGTTTAAAGCTCGCCGA
TTTCTACAATAATATGAGG -> TTCTACAATAATATGAGGC
TTTGCCGGAGATCTTCGCT -> TTGCCGGAGATCTTCGCTA
TTTGCGTCGCTTAGAACTG -> TTGCGTCGCTTAGAACTGC
TTTGCTCCTCGGCCAATAC -> TTGCTCCTCGGCCAATACA
TTTGGGCGGACAGCGGCCG -> TTGGGCGGACAGCGGCCGT
TTTGGTTTCCGCGGAGTAA -> TTGGTTTCCGCGGAGTAAA
TTTGTAAGAGTGATCTCAC -> TTGTAAGAGTGATCTCACA
TTTGTATGCAGTTACGACT -> TTGTATGCAGTTACGACTG
TTTGTCACTTCCAGCCGTA -> TTGTCACTTCCAGCCGTAG
TTTGTGCCCAGAGTGACAG -> TTGTGCCCAGAGTGACAGT
TTTTAAGGACTCGTCTTAC -> TTTAAGGACTCGTCTTACG
TTTTCCGGTGATATACTTT -> TTTCCGGTGATATACTTTA
TTTTCTACAATAATATGAG -> TTTCTACAATAATATGAGG
TTTTGCGTCGCTTAGAACT -> TTTGCGTCGCTTAGAACTG
TTTTGCTCCTCGGCCAATA -> TTTGCTCCTCGGCCAATAC
TTTTGTAAGAGTGATCTCA -> TTTGTAAGAGTGATCTCAC
TTTTGTATGCAGTTACGAC -> TTTGTATGCAGTTACGACT
TTTTTCTACAATAATATGA -> TTTTCTACAATAATATGAG
TTTTTGCGTCGCTTAGAAC -> TTTTGCGTCGCTTAGAACT
TTTTTGCTCCTCGGCCAAT -> TTTTGCTCCTCGGCCAATA
TTTTTGTAAGAGTGATCTC -> TTTTGTAAGAGTGATCTCA
TTTTTTGCTCCTCGGCCAA -> TTTTTGCTCCTCGGCCAAT
TTTTTTGTAAGAGTGATCT -> TTTTTGTAAGAGTGATCTC
TTTTTTTGTAAGAGTGATC -> TTTTTTGTAAGAGTGATCT
